"a" = (/turf/UnbreakableTurfs/Void_Wall,/area/Outside)
"b" = (/turf/Other/Blank,/area/Outside)
"c" = (/obj/dungeon_exit,/turf/Other/Blank,/area/Outside)
"d" = (/turf/Other/Blank,/area/dungeon_area)
"e" = (/turf/CastleFloor/Pyramid,/area/dungeon_area)
"f" = (/obj/buildables/Fire,/turf/Grass/Grass10,/area/dungeon_area)
"g" = (/mob/npc/Enemy/Zombie,/turf/CastleFloor/Pyramid,/area/dungeon_area)
"h" = (/mob/npc/Enemy/Decaying_Skeleton,/turf/CastleFloor/Pyramid,/area/dungeon_area)
"i" = (/obj/Container/Chest,/turf/CastleFloor/Pyramid,/area/dungeon_area)
"j" = (/obj/items/Dungeon_Needle,/turf/CastleFloor/Pyramid,/area/dungeon_area)
"k" = (/obj/Trap/teletrap{goto_x = 45; goto_y = 74},/turf/CastleFloor/Pyramid,/area/dungeon_area)
"l" = (/mob/npc/Enemy/Mindless_Lich,/turf/CastleFloor/Pyramid,/area/dungeon_area)
"m" = (/obj/Trap/spikes,/turf/CastleFloor/Pyramid,/area/dungeon_area)
"n" = (/obj/Trap/caltrops,/turf/CastleFloor/Pyramid,/area/dungeon_area)
"o" = (/mob/npc/Enemy/Bosses/Master_Of_Zombies,/turf/CastleFloor/Pyramid,/area/dungeon_area)
"p" = (/obj/items/Clawed_Talisman,/turf/CastleFloor/Pyramid,/area/dungeon_area)
"q" = (/obj/items/Bio_Field,/turf/Other/Blank,/area/dungeon_area)
"r" = (/obj/items/Bandages,/turf/CastleFloor/Pyramid,/area/dungeon_area)
"s" = (/obj/Artifacts/Boosters/Willpower_Gem,/turf/CastleFloor/Pyramid,/area/dungeon_area)
"t" = (/mob/npc/Enemy/Bosses/Vampiric_Immortal,/turf/CastleFloor/Pyramid,/area/dungeon_area)
"u" = (/obj/Trap/muck,/turf/CastleFloor/Pyramid,/area/dungeon_area)
"v" = (/obj/SacredGroveGate,/turf/CastleFloor/Pyramid,/area/dungeon_area)
"w" = (/mob/npc/Enemy/Bosses/Lich,/turf/CastleFloor/Pyramid,/area/dungeon_area)
"x" = (/obj/items/Omniwatch,/turf/CastleFloor/Pyramid,/area/dungeon_area)
"y" = (/obj/items/Anti_Virus/Anti_Virus_Daybreaker,/turf/CastleFloor/Pyramid,/area/dungeon_area)
"z" = (/obj/items/food/Apple_Of_Eden,/turf/CastleFloor/Pyramid,/area/dungeon_area)
"A" = (/obj/items/Infinity_Stone_Holder,/turf/CastleFloor/Pyramid,/area/dungeon_area)
"B" = (/mob/npc/Enemy/Bosses/Alarato_Lich,/turf/CastleFloor/Pyramid,/area/dungeon_area)
"C" = (/obj/Artifacts/Blood_Chalice,/turf/CastleFloor/Pyramid,/area/dungeon_area)
"D" = (/obj/dungeon_exit{isClearingExit = 1},/turf/CastleFloor/Pyramid,/area/dungeon_area)
"E" = (/turf/UnbreakableTurfs/Void_Wall,/area/dungeon_area)

(1,1,1) = {"
aaaaaaaaaaaaaaaaaaaaaaaaaaaaaaaaaaaaaaaaaaaaaaaaaaaaaaaaaaaaaaaaaaaaaaaaaaaaaaaaaaaaaaaaaaaaaaaaaaaaaaaaaaaaaaaaaaaaaaaaaaaaa
aaaaaaaaaaaaaaaaaaaaaaaaaaaaaaaaaaaaaaaaaaaaaaaaaaaaaaaaaaaaaaaaaaaaaaaaaaaaaaaaaaaaaaaaaaaaaaaaaaaaaaaaaaaaaaaaaaaaaaaaaaaaa
aaaaaaaaaaaaaaaaaaaaaaaaaaaaaaaaaaaaaaaaaaaaaaaaaaaaaaaaaaaaaaaaaaaaaaaaaaaaaaaaaaaaaaaaaaaaaaaaaaaaaaaaaaaaaaaaaaaaaaaaaaaaa
aaabbbbbbbbbbbbbbbbbbbbbbbbbbbbbbbbbbbbbbbbbbbbbbbbbbbbbbbbbbbbbbbbbbbbbbbbbbbbbbbbbbbbbbbbbbbbbbbbbbbbbbbbbbbbbbbbbbbbbbbaaa
aaabbbbbbbbbbbbbbbbbbbbbbbbbbbbbbbbbbbbbbbbbbbbbbbbbbbcbbbbbbbbbbbbbbbbbbbbbbbbbbbbbbbbbbbbbbbbbbbbbbbbbbbbbbbbbbbbbbbbbbbaaa
aaabbbbbbbbbbbbbbbbbbbbbbbbbbbbbbbbbbbbbbbbbbbbbbbbbbbbbbbbbbbbbbbbbbbbbbbbbbbbbbbbbbbbbbbbbbbbbbbbbbbbbbbbbbbbbbbbbbbbbbbaaa
aaabbbbbbbbbbbbbbbbbbbbbbbbbbbbbbbbbbbbbbbbbbbbbbbbbbbbbbbbbbbbbbbbbbbbbbbbbbbbbbbbbbbbbbbbbbbbbbbbbbbbbbbbbbbbbbbbbbbbbbbaaa
aaabbbbbbbbbbbbbbbbbbbbbbbbbbbbbbbbbbbbbbbbbbbbbbddddeeeddddbbbbbbbbbbbbbbbbbbbbbbbbbbbbbbbbbbbbbbbbbbbbbbbbbbbbbbbbbbbbbbaaa
aaabbbbbbbbbbbbbbbbbbbbbbbbbbbbbbbbbbbbbbbbbbbbbbeeeeeeeeeeebbbbbbbbbbbbbbbbbbbbbbbbbbbbbbbbbbbbbbbbbbbbbbbbbbbbbbbbbbbbbbaaa
aaabbbbbbbbbbbbbbbbbbbbbbbbbbbbbbbbbbbbbbbbbbbbbbeeeeeeeeeeebbbbbbbbbbbbbbbbbbbbbbbbbbbbbbbbbbbbbbbbbbbbbbbbbbbbbbbbbbbbbbaaa
aaabbbbbbbbbbbbbbbbbbbbbbbbbbbbbbbbbbbbbbbbbbbbbbeeeeefeeeeebbbbbbbbbbbbbbbbbbbbbbbbbbbbbbbbbbbbbbbbbbbbbbbbbbbbbbbbbbbbbbaaa
aaabbbbbbbbbbbbbbbbbbbbbbbbbbbbbbbbbbbbbbbbbbbbbbeeeeeeeeeeebbbbbbbbbbbbbbbbbbbbbbbbbbbbbbbbbbbbbbbbbbbbbbbbbbbbbbbbbbbbbbaaa
aaabbbbbbbbbbbbbbbbbbbbbbbbbbbbbbbbbbbbbbbbbbbbbbeeeeeeeeeeebbbbbbbbbbbbbbbbbbbbbbbbbbbbbbbbbbbbbbbbbbbbbbbbbbbbbbbbbbbbbbaaa
aaabbbbbbbbbbbbbbbbbbbbbbbbbbbbbbbbbbbbbbbbbbbbbbeeeeeeeeeeebbbbbbbbbbbbbbbbbbbbbbbbbbbbbbbbbbbbbbbbbbbbbbbbbbbbbbbbbbbbbbaaa
aaabbbbbbbbbbbbbbbbbbbbbbbbbbbbbbbbbbbbbbbbbbbbbbeeeeeeeeeeebbbbbbbbbbbbbbbbbbbbbbbbbbbbbbbbbbbbbbbbbbbbbbbbbbbbbbbbbbbbbbaaa
aaabbbbbbbbbbbbbbbbbbbbbbbbbbbbbbbbbbbbbbbbbbbbbbeeeeeeeeeeebbbbbbbbbbbbbbbbbbbbbbbbbbbbbbbbbbbbbbbbbbbbbbbbbbbbbbbbbbbbbbaaa
aaabbbbbbbbbbbbbbbbbbbbbbbbbbbbbbbbbbbbbbbbbbbbbbeeeeeeeeeeebbbbbbbbbbbbbbbbbbbbbbbbbbbbbbbbbbbbbbbbbbbbbbbbbbbbbbbbbbbbbbaaa
aaabbbbbbbbbbbbbbbbbbbbbbbbbbbbbbbbbbbbbbbbbbbbbbdddddedddddbbbbbbbbbbbbbbbbbbbbbbbbbbbbbbbbbbbbbbbbbbbbbbbbbbbbbbbbbbbbbbaaa
aaabbbbbbbbbbbbbbbbbbbbbbbbbbbbbbbbbbbbbbbbbbbbbbdddeeeeedddbbbbbbbbbbbbbbbbbbbbbbbbbbbbbbbbbbbbbbbbbbbbbbbbbbbbbbbbbbbbbbaaa
aaabbbbbbbbbbbbbbbbbbbbbbbbbbbbbbbbbbbbbbbbbbbbbbddeeeeeeeddbbbbbbbbbbbbbbbbbbbbbbbbbbbbbbbbbbbbbbbbbbbbbbbbbbbbbbbbbbbbbbaaa
aaabbbbbbbbbbbbbbbbbbbbbbbbbbbbbbbbbbbbbbbbbbbbbbddedddddeddbbbbbbbbbbbbbbbbbbbbbbbbbbbbbbbbbbbbbbbbbbbbbbbbbbbbbbbbbbbbbbaaa
aaabbbbbbbbbbbbbbbbbbbbbbbbbbbbbbbbbbbbbbbbbbbbbbddeeeeeeeddbbbbbbbbbbbbbbbbbbbbbbbbbbbbbbbbbbbbbbbbbbbbbbbbbbbbbbbbbbbbbbaaa
aaabbbbbbbbbbbbbbbbbbbbbbbbbbbbbbbbbbbbbbbbbbbbbbddeeegeeeddbbbbbbbbbbbbbbbbbbbbbbbbbbbbbbbbbbbbbbbbbbbbbbbbbbbbbbbbbbbbbbaaa
aaabbbbbbbbbbbbbbbbbbbbbbbbbbbbbbbbbbbbbbbbbbbbbbddeeheheeddbbbbbbbbbbbbbbbbbbbbbbbbbbbbbbbbbbbbbbbbbbbbbbbbbbbbbbbbbbbbbbaaa
aaabbbbbbbbbbbbbbbbbbbbbbbbbbbbbbbbbbbbbbbbbbbbbbddeeeeeeedddbbbbbbbbbbbbbbbbbbbbbbbbbbbbbbbbbbbbbbbbbbbbbbbbbbbbbbbbbbbbbaaa
aaabbbbbbbbbbbbbbbbbbbbbbbbbbbbbbbbbbbbbbbbbbbbbbddddEedddddddddddddddddddddeeeijeeeddddddddddddddddddddddddbbbbbbbbbbbbbbaaa
aaabbbbbbbbbbbbbbbbbbbbbbbbbbbbbbbbbbbbbbbbbbbbbbddeeeeeeeddddddddddddddddddeeeekeeeddddddddddddddddddddddddbbbbbbbbbbbbbbaaa
aaabbbbbbbbbbbbbbbbbbbbbbbbbbbbbbbeeeeeedddddddddddeeeeeeeddddddddddddddddddeeeleeeeddddddddddddddddddddddddbbbbbbbbbbbbbbaaa
aaabbbbbbbbbbbbbbbbbbbbbbbbbbbbbbbeeeeeeddddddddddeeeemeheedddddddddddddddddeeheeeeeddddddddddddddddddddddddbbbbbbbbbbbbbbaaa
aaabbbbbbbbbbbbbbbbbbbbbbbbbbbbbbbeeddedddddddddddeeeeeeeeedddddddddddddddddeeeeleeeddddddddddddddddddddddddbbbbbbbbbbbbbbaaa
aaabbbbbbbbbbbbbbbbbbbbbbbbbbbbbbbeedeeeddddddddddeeeeeegeeddddddddddddddddddeeeeeeeddddddddddddddddddddddddbbbbbbbbbbbbbbaaa
aaabbbbbbbbbbbbbbbbbbbbbbbbbbbbbbbeedeehdeeeeeeeeeegeheheeeeeeeeeeeeddddddddeeeeeeeeddddddddddddddddddddddddbbbbbbbbbbbbbbaaa
aaabbbbbbbbbbbbbbbbbbbbbbbbbbbbbbbeedeeedeeeeeeeeeeeeeeeeeeeeeeeeeeedddddddeeeddddddddddddddddddddddddddddddbbbbbbbbbbbbbbaaa
aaabbbbbbbbbbbbbbbbbbbbbbbbbbbbbbbhedehedeedddddddddddddddddddddddeeeeeeeeeeddddddddddddddddddddddddddddddddbbbbbbbbbbbbbbaaa
aaabbbbbbbbbbbbbbbbbbbbbbbbbbbbbbbehdeeedeldeeeeeeeeeeeeeeeeeeeeedleddddddddddddddddddddddddddddddddddddddddbbbbbbbbbbbbbbaaa
aaabbbbbbbbbbbbbbbbbbbbbbbbbbbbbbbeedddddhedeeeeeeeeeeeeeeeeeeenedehddddddddddddddddddddddddddddddddddddddddbbbbbbbbbbbbbbaaa
aaabbbbbbbbbbbbbbbbbbbbbbbbbbbbbbbeeeeeeeeedeeeeeeeeeeeeeeeeeeeeedeeddddddddddddddddddddddddddddddddddddddddbbbbbbbbbbbbbbaaa
aaabbbbbbbbbbbbbbbbbbbbbbbbbbbbbbbeedddddeeeeeeeeeeeeeeeeeeeeeeeeeeeddddddddddddddddddddddddddddddddddddddddbbbbbbbbbbbbbbaaa
aaabbbbbbbbbbbbbbbbbbbbbbbbbbbbbbbeedeeedeedeeeeeeeeleeeeeeeeeeeedeeddddddddddddddddddddddddddddddddddddddddbbbbbbbbbbbbbbaaa
aaabbbbbbbbbbbbbbbbbbbbbbbbbbbbbbbeedeeedeedeeeeeeeeeoleeeeeeeeeedeeddddddddddddddddddddddddddddddddddddddddbbbbbbbbbbbbbbaaa
aaabbbbbbbbbbbbbbbbbbbbbbbbbbbbbbbeedeeedeedeeeeeeeeeeeeeeeeeeeeedeeddddddddddddddddddddddddddddddddddddddddbbbbbbbbbbbbbbaaa
aaabbbbbbbbbbbbbbbbbbbbbbbbbbbbbbbehdeeeddddeemeeeeeeeeeeeeeeeeeedddddddddddddddddddddddddddddddddddddddddddbbbbbbbbbbbbbbaaa
aaabbbbbbbbbbbbbbbbbbbbbbbbbbbbbbbhedeeeeeddeeeeeeeeeeeeeeeeeeeeedddddddddddddddddddddddddddddddddddddddddddbbbbbbbbbbbbbbaaa
aaabbbbbbbbbbbbbbbbbbbbbbbbbbbbbbbeedeeeeedddddddddddeedddddddddddddddddddddddddddddddddddddddddddddddddddddbbbbbbbbbbbbbbaaa
aaabbbbbbbbbbbbbbbbbbbbbbbbbbbbbbbeedeeeeedddddddddddeedddddddddddddddddddddddddddddddddddddddddddddddddddddbbbbbbbbbbbbbbaaa
aaabbbbbbbbbbbbbbbbbbbbbbbbbbbbbbbeededddddddddddddddeedddddddddddddddddddddddddddddddddddddddddddddddddddddbbbbbbbbbbbbbbaaa
aaabbbbbbbbbbbbbbbbbbbbbbbbbbbbbbbeededeieeddddddddddeedddddddddddddddddddddddddddddddddddddddddddddddddddddbbbbbbbbbbbbbbaaa
aaabbbbbbbbbbbbbbbbbbbbbbbbbbbbbbbeedddeeheddddddddddeedddddddddddddddddddddddddddddddddddddddddddddddddddddbbbbbbbbbbbbbbaaa
aaabbbbbbbbbbbbbbbbbbbbbbbbbbbbbbbeeeeeeeeeddddddddddeedddddddddddddddddddddddddddddddddddddddddddddddddddddbbbbbbbbbbbbbbaaa
aaabbbbbbbbbbbbbbbbbbbbbbbbbbbbbbbdddddehepddddddddddeedddddddddddddddddddddddddddddeeheeeeeeleeeeeeeeeeeeeebbbbbbbbbbbbbbaaa
aaabbbbbbbbbbbbbbbbbbbbbbbbbbbbbbbdddeeeeeeddddddddddeedddddddddddddddddddddddddddddeeeeeheeeeeeeeeeeeeeeehebbbbbbbbbbbbbbaaa
aaabbbbbbbbbbbbbbbbbbbbbbbbbbbbbbbdddeeeeeeddddddddddeedddddddddddddddddddddddddddddeddddddddddddddddddddeeebbbbbbbbbbbbbbaaa
aaabbbbbbbbbbbbbbbbbbbbbbbbbbbbbbbdddddddddddddddddddhedddddddddddddddddddddddddddddeddddddddddddddddddddeeebbbbbbbbbbbbbbaaa
aaabbbbbbbbbbbbbbbbbbbbbbbbbbbbbbbdddddddddddddddddddehdddddddddddddddddddddddddddddeddeeeeeeeeeeeeeedddeeeebbbbbbbbbbbbbbaaa
aaabbbbbbbbbbbbbbbbbbbbbbbbbbbbbbbdddddddddddddddddddeedddddddddddddddddddddddddddddeddeeeeeeeeeeeheedddeeeebbbbbbbbbbbbbbaaa
aaabbbbbbbbbbbbbbbbbbbbbbbbbbbbbbbddddddddeeeeeeeeeeeeeeeeeeeeeeeeeeedddddddqdddddddeddeeeeeheeeeeeeedddeeehbbbbbbbbbbbbbbaaa
aaabbbbbbbbbbbbbbbbbbbbbbbbbbbbbbbddddddddeeeeeeeeeeeheeeeeeeeeeeeeeedddddddddddddddeddeeeeeeeeeeeeeedddeeeebbbbbbbbbbbbbbaaa
aaabbbbbbbbbbbbbbbbbbbbbbbbbbbbbbbddddddddeeddeeeeeeeeeheeeeeeeeeddeedddddddddddddddeddeeeeeeeeeeeeeedddeeeebbbbbbbbbbbbbbaaa
aaabbbbbbbbbbbbbbbbbbbbbbbbbbbbbbbddddddddeeddeeeheeeeeeeeheeeeeeddeedddddddddddddddedddddeeeeeeeeeeedddeeeebbbbbbbbbbbbbbaaa
aaabbbbbbbbbbbbbbbbbbbbbbbbbbbbbbbddddddddeeeieeeeeheeeeeeeeeeeeeeeeeddeeeeiirreeeeeeeeeedeeeeeeeeeeedddeeeebbbbbbbbbbbbbbaaa
aaabbbbbbbbbbbbbbbbbbbbbbbbbbbbbbbddddddddeeeeeeeeeeeeeeeheeeheeeeeeeddeeeeeeeeeeeeeeeeeedeeheeeheeeedddeheebbbbbbbbbbbbbbaaa
aaabbbbbbbbbbbbbbbbbbbbbbbbbbbbbbbddddddddeeddeeeeheeeeeheeeeeeeeddeeddeeeeeeeeeeeeeeeeeedeeeeeeeleeedddeeeebbbbbbbbbbbbbbaaa
aaabbbbbbbbbbbbbbbbbbbbbbbbbbbbbbbddddddddeeddeeeeeeheeeeeeeeeeheddeeddeeeeeeeeeeeeeeeeeedeeeeeheeeeedddeeelbbbbbbbbbbbbbbaaa
aaabbbbbbbbbbbbbbbbbbbbbbbbbbbbbbbddddddddeeeeeeeeeeeeeeeeeeeeeeeeeeeddeeeeeeeeeeeeeeeeeedeeeeeeeeeeedddeeeebbbbbbbbbbbbbbaaa
aaabbbbbbbbbbbbbbbbbbbbbbbbbbbbbbbddddddddeeeeeeeeeeeeeeeheeeeeeeeeeeddeeeeeeeeseeeeeeeeedeeeeeeeeeeedddeeeebbbbbbbbbbbbbbaaa
aaabbbbbbbbbbbbbbbbbbbbbbbbbbbbbbbddddddddeeddeheeeeheeheeeheeeeeddeeddeeeeeeeeeeeeeeeeeedeeeheeeeeeedddeeeebbbbbbbbbbbbbbaaa
aaabbbbbbbbbbbbbbbbbbbbbbbbbbbbbbbddddddddeeddeeeeeeeeeeeeeeeeeeeddeeddeeeeeeeeteeeeeeeeedeeeeeeeeeeedddeeehbbbbbbbbbbbbbbaaa
aaabbbbbbbbbbbbbbbbbbbbbbbbbbbbbbbddddddddeeeeeeeeeeheeeeeeeeeeeeeeeeddeeeeeeeeeeeeeeeeeedeeeeeeeeeeedddeeeebbbbbbbbbbbbbbaaa
aaabbbbbbbbbbbbbbbbbbbbbbbbbbbbbbbddddddddeeeeeeeeeeeeeeeeeeheeeeeeeeddeeeeeeeeeeeeeeeeeedeeeeeeeheeedddeeeebbbbbbbbbbbbbbaaa
aaabbbbbbbbbbbbbbbbbbbbbbbbbbbbbbbddddddddeeddeeeeeeeeeheheeeeeeeddeeddeeeeeeeeeeeeeeeeeedeeeleeeeeeedddeheebbbbbbbbbbbbbbaaa
aaabbbbbbbbbbbbbbbbbbbbbbbbbbbbbbbddddddddeeddeeheeeeeeeeeeeeeheeddeeddeeeeeeeeeeeeeeeeeedeeeeeeeeeeedddeeeebbbbbbbbbbbbbbaaa
aaabbbbbbbbbbbbbbbbbbbbbbbbbbbbbbbddddddddeeeeeeeeeheeeheeeeeeeeeeeeeddeeeeeeeeeeeeeeeeeedeeeeeeeeeeedddeeeebbbbbbbbbbbbbbaaa
aaabbbbbbbbbbbbbbbbbbbbbeeeeeeeeeeeeeeedddeeeeeeeeeeeeeeeeeeeheeeeeeeddeeeeeeeeeeeeeeeeeedeheeeddeeeedddeeeebbbbbbbbbbbbbbaaa
aaabbbbbbbbbbbbbbbbbbbbbeeheeeeeeeeeeeedddeeddeeeeeeheeeeeeeeeeeeddeeddeeeeeeeeeeeeeeeeeedeeeeeddeeeedddeehebbbbbbbbbbbbbbaaa
aaabbbbbbbbbbbbbbbbbbbbbeeeeeeeeeeeeeeedddeeddeeeeeeeeeeeeeeeeeeeddeeddeeeeeeeeeeeeeeeeeedeeeeeddeeeeeddeelebbbbbbbbbbbbbbaaa
aaabbbbbbbbbbbbbbbbbbbbbeeheeeedddeeheeddddddddddddddeuddddddddddddddddeeeedddddddddddddddeeeeeddeeeeeddeeeebbbbbbbbbbbbbbaaa
aaabbbbbbbbbbbbbbbbbbbbbeeeeeeedddeeeheddddddddddddddeeddddddddddddddddeeeededddddddddddeeeeeeeddeeeeeddeeeebbbbbbbbbbbbbbaaa
aaabbbbbbbbbbbbbbbbbbbbbedddddddddeeeeeeeeeeeeeeeeeeeeeeeeeeeeeeeeeeeeeeeeeeedddddddddddeeeeeeeddeeeeeddeeeebbbbbbbbbbbbbbaaa
aaabbbbbbbbbbbbbbbbbbbbbedddddddddeeeeeeeeeeeeeeeeeeeeeeeeeeeeeeeeeeeeeeeeeeedddddddddddeeeeeeeddeeeeeddeeeebbbbbbbbbbbbbbaaa
aaabbbbbbbbbbbbbbbbbbbbbeeeeddedddddddddddddddddddddddddddddddddddddddddddddddddddddddddeeeeeeeddeeeeeddeeeebbbbbbbbbbbbbbaaa
aaabbbbbbbbbbbbbbbbbbbbbeeeeddedddddddddddddddddddddddddddddddddddddddddddddddddddddddddeeeeeeeddeeeeeddeeeebbbbbbbbbbbbbbaaa
aaabbbbbbbbbbbbbbbbbbbbbeheeddeeeeeeeeeeeeeeeeeeeeeedeueeeeeeeeeeeddddddddddddddddddddddeeeeeeeddeeeeeddeeeebbbbbbbbbbbbbbaaa
aaabbbbbbbbbbbbbbbbbbbbbeeeeddeeeeeeeeheeeeeeeeeeeeededeeeeeeeeevedddddddddddddddddddddddddddeeddeeeeeeeeeeebbbbbbbbbbbbbbaaa
aaabbbbbbbbbbbbbbbbbbbbbeeheddeeeeeeeeeeeeeeeeeeeeeeeedeeeeeeeeeeeddddddddddddddddddddddieeeeeeddeeeeeeeeeeebbbbbbbbbbbbbbaaa
aaabbbbbbbbbbbbbbbbbbbbbeeeeddeeeeheeeeeeeheeedeeddddddddddddddddddddddddddddddddddddddddeeddddddddddddddeedbbbbbbbbbbbbbbaaa
aaabbbbbbbbbbbbbbbbbbbbbeeeeeeeeeeeeeeeeeeeeeedeenedeeeeeedeeeeeeeeeeeeeeeeeeeeeeeeeeeeeeeeeeeeeeeeeeeeedeeebbbbbbbbbbbbbbaaa
aaabbbbbbbbbbbbbbbbbbbbbbbbbbbbbbbdddddddddddddeeeedeheeeededeeeeheeeeeeeheeeeeeeeeeeeeeddddeeeeeeeeeeeedeeebbbbbbbbbbbbbbaaa
aaabbbbbbbbbbbbbbbbbbbbbbbbbbbbbbbdddddddddddddeeeedeeeehededeeeeeeeeeeeeeeeeeheeeeeeheeeeeeeeeeeeeeheeedeeebbbbbbbbbbbbbbaaa
aaabbbbbbbbbbbbbbbbbbbbbbbbbbbbbbbdddddddddddddeeeeeeeeeeeeedeeeeheeeeheeeeeeeeeeheeeeeeeeeeeeheeeeeeeeedeeebbbbbbbbbbbbbbaaa
aaabbbbbbbbbbbbbbbbbbbbbbbbbbbbbbbbbbbbbbbbbbbbbbdddddeeddddddeeeeeeeeeeeeeeeeeeeeeeeeeeeeeeeeeeeeeeeeeeeeeebbbbbbbbbbbbbbaaa
aaabbbbbbbbbbbbbbbbbbbbbbbbbbbbbbbbbbbbbbbbbbbbbbdddddeeddddddbbbbbbbbbbbbbbbbbbbbbbbbbbbbbbbbbbbbbbbbbbbbbbbbbbbbbbbbbbbbaaa
aaabbbbbbbbbbbbbbbbbbbbbbbbbbbbbbbbbbbbbbbbbbbbbbdeeeeeeeeeebbbbbbbbbbbbbbbbbbbbbbbbbbbbbbbbbbbbbbbbbbbbbbbbbbbbbbbbbbbbbbaaa
aaabbbbbbbbbbbbbbbbbbbbbbbbbbbbbbbbbbbbbbbbbbbbbbdeeeeeeeeeebbbbbbbbbbbbbbbbbbbbbbbbbbbbbbbbbbbbbbbbbbbbbbbbbbbbbbbbbbbbbbaaa
aaabbbbbbbbbbbbbbbbbbbbbbbbbbbbbbbbbbbbbbbbbbbbbbdeeeeeeeeeebbbbbbbbbbbbbbbbbbbbbbbbbbbbbbbbbbbbbbbbbbbbbbbbbbbbbbbbbbbbbbaaa
aaabbbbbbbbbbbbbbbbbbbbbbbbbbbbbbbbbbbbbbbbbbbbbbdeeeeeeeeeebbbbbbbbbbbbbbbbbbbbbbbbbbbbbbbbbbbbbbbbbbbbbbbbbbbbbbbbbbbbbbaaa
aaabbbbbbbbbbbbbbbbbbbbbbbbbbbbbbbbbbbbbbbbbbbbbbdeeeeeweeeebbbbbbbbbbbbbbbbbbbbbbbbbbbbbbbbbbbbbbbbbbbbbbbbbbbbbbbbbbbbbbaaa
aaabbbbbbbbbbbbbbbbbbbbbbbbbbbbbbbbbbbbbbbbbbbbbbdeeeeeeeeeebbbbbbbbbbbbbbbbbbbbbbbbbbbbbbbbbbbbbbbbbbbbbbbbbbbbbbbbbbbbbbaaa
aaabbbbbbbbbbbbbbbbbbbbbbbbbbbbbbbbbbbbbbbbbbbbbbdeddddddddebbbbbbbbbbbbbbbbbbbbbbbbbbbbbbbbbbbbbbbbbbbbbbbbbbbbbbbbbbbbbbaaa
aaabbbbbbbbbbbbbbbbbbbbbbbbbbbbbbbbbbbbbbbbbbbbbbdeeeeeeeeeebbbbbbbbbbbbbbbbbbbbbbbbbbbbbbbbbbbbbbbbbbbbbbbbbbbbbbbbbbbbbbaaa
aaabbbbbbbbbbbbbbbbbbbbbbbbbbbbbbbbbbbbbbbbbbbbbbddddeeeddddbbbbbbbbbbbbbbbbbbbbbbbbbbbbbbbbbbbbbbbbbbbbbbbbbbbbbbbbbbbbbbaaa
aaabbbbbbbbbbbbbbbbbbbbbbbbbbbbbbbbbbbbbbbbbbbbbbddddeeeddddbbbbbbbbbbbbbbbbbbbbbbbbbbbbbbbbbbbbbbbbbbbbbbbbbbbbbbbbbbbbbbaaa
aaabbbbbbbbbbbbbbbbbbbbbbbbbbbbbbbbbbbbbbbbEexiyeedddeeedddeeeziAeeEbbbbbbbbbbbbbbbbbbbbbbbbbbbbbbbbbbbbbbbbbbbbbbbbbbbbbbaaa
aaabbbbbbbbbbbbbbbbbbbbbbbbbbbbbbbbbbbbbbbbeeeeeeeeddeeeddeeeeeeeeeebbbbbbbbbbbbbbbbbbbbbbbbbbbbbbbbbbbbbbbbbbbbbbbbbbbbbbaaa
aaabbbbbbbbbbbbbbbbbbbbbbbbbbbbbbbbbbbbbbbbeeeeeeeeedeeedeeeeeeeeeeebbbbbbbbbbbbbbbbbbbbbbbbbbbbbbbbbbbbbbbbbbbbbbbbbbbbbbaaa
aaabbbbbbbbbbbbbbbbbbbbbbbbbbbbbbbbbbbbbbbbeeeeeeeeeeeeeeeeeeeeeeeeebbbbbbbbbbbbbbbbbbbbbbbbbbbbbbbbbbbbbbbbbbbbbbbbbbbbbbaaa
aaabbbbbbbbbbbbbbbbbbbbbbbbbbbbbbbbbbbbbbbbeeeeeeeeeeeeeeeeeeeeeeeeebbbbbbbbbbbbbbbbbbbbbbbbbbbbbbbbbbbbbbbbbbbbbbbbbbbbbbaaa
aaabbbbbbbbbbbbbbbbbbbbbbbbbbbbbbbbbbbbbbbbeeeeeeeeeeeeeeeeeeeeeeeeebbbbbbbbbbbbbbbbbbbbbbbbbbbbbbbbbbbbbbbbbbbbbbbbbbbbbbaaa
aaabbbbbbbbbbbbbbbbbbbbbbbbbbbbbbbbbbbbbbbbeeeeeeeeeeeeeeeeeeeeeeeeebbbbbbbbbbbbbbbbbbbbbbbbbbbbbbbbbbbbbbbbbbbbbbbbbbbbbbaaa
aaabbbbbbbbbbbbbbbbbbbbbbbbbbbbbbbbbbbbbbbbeeeeeeeeeeeeeeeeeeeeeeeeebbbbbbbbbbbbbbbbbbbbbbbbbbbbbbbbbbbbbbbbbbbbbbbbbbbbbbaaa
aaabbbbbbbbbbbbbbbbbbbbbbbbbbbbbbbbbbbbbbbbeeeeeeeeeeeeeeeeeeeeeeeeebbbbbbbbbbbbbbbbbbbbbbbbbbbbbbbbbbbbbbbbbbbbbbbbbbbbbbaaa
aaabbbbbbbbbbbbbbbbbbbbbbbbbbbbbbbbbbbbbbbbeeeeeeeeeeeBeeeeeeeeeeeeebbbbbbbbbbbbbbbbbbbbbbbbbbbbbbbbbbbbbbbbbbbbbbbbbbbbbbaaa
aaabbbbbbbbbbbbbbbbbbbbbbbbbbbbbbbbbbbbbbbbeeeeeeeeeeeeeeeeeeeeeeeeebbbbbbbbbbbbbbbbbbbbbbbbbbbbbbbbbbbbbbbbbbbbbbbbbbbbbbaaa
aaabbbbbbbbbbbbbbbbbbbbbbbbbbbbbbbbbbbbbbbbeeeeeeeeeeeeeeeeeeeeeeeeebbbbbbbbbbbbbbbbbbbbbbbbbbbbbbbbbbbbbbbbbbbbbbbbbbbbbbaaa
aaabbbbbbbbbbbbbbbbbbbbbbbbbbbbbbbbbbbbbbbbEeeeeeeeeeeCeeeeeeeeeeeeEbbbbbbbbbbbbbbbbbbbbbbbbbbbbbbbbbbbbbbbbbbbbbbbbbbbbbbaaa
aaabbbbbbbbbbbbbbbbbbbbbbbbbbbbbbbbbbbbbbbbbbbbbbbbbeeeeebbbbbbbbbbbbbbbbbbbbbbbbbbbbbbbbbbbbbbbbbbbbbbbbbbbbbbbbbbbbbbbbbaaa
aaabbbbbbbbbbbbbbbbbbbbbbbbbbbbbbbbbbbbbbbbbbbbbbbbaaeeeEabbbbbbbbbbbbbbbbbbbbbbbbbbbbbbbbbbbbbbbbbbbbbbbbbbbbbbbbbbbbbbbbaaa
aaabbbbbbbbbbbbbbbbbbbbbbbbbbbbbbbbbbbbbbbbbbbbbbbbaaeDeEabbbbbbbbbbbbbbbbbbbbbbbbbbbbbbbbbbbbbbbbbbbbbbbbbbbbbbbbbbbbbbbbaaa
aaabbbbbbbbbbbbbbbbbbbbbbbbbbbbbbbbbbbbbbbbbbbbbbbbaaeeeEabbbbbbbbbbbbbbbbbbbbbbbbbbbbbbbbbbbbbbbbbbbbbbbbbbbbbbbbbbbbbbbbaaa
aaabbbbbbbbbbbbbbbbbbbbbbbbbbbbbbbbbbbbbbbbbbbbbbbbaaeeeEabbbbbbbbbbbbbbbbbbbbbbbbbbbbbbbbbbbbbbbbbbbbbbbbbbbbbbbbbbbbbbbbaaa
aaabbbbbbbbbbbbbbbbbbbbbbbbbbbbbbbbbbbbbbbbbbbbbbbbaabbbaabbbbbbbbbbbbbbbbbbbbbbbbbbbbbbbbbbbbbbbbbbbbbbbbbbbbbbbbbbbbbbbbaaa
aaabbbbbbbbbbbbbbbbbbbbbbbbbbbbbbbbbbbbbbbbbbbbbbbbaabbbaabbbbbbbbbbbbbbbbbbbbbbbbbbbbbbbbbbbbbbbbbbbbbbbbbbbbbbbbbbbbbbbbaaa
aaabbbbbbbbbbbbbbbbbbbbbbbbbbbbbbbbbbbbbbbbbbbbbbbbaabbbaabbbbbbbbbbbbbbbbbbbbbbbbbbbbbbbbbbbbbbbbbbbbbbbbbbbbbbbbbbbbbbbbaaa
aaaaaaaaaaaaaaaaaaaaaaaaaaaaaaaaaaaaaaaaaaaaaaaaaaaaaaaaaaaaaaaaaaaaaaaaaaaaaaaaaaaaaaaaaaaaaaaaaaaaaaaaaaaaaaaaaaaaaaaaaaaaa
aaaaaaaaaaaaaaaaaaaaaaaaaaaaaaaaaaaaaaaaaaaaaaaaaaaaaaaaaaaaaaaaaaaaaaaaaaaaaaaaaaaaaaaaaaaaaaaaaaaaaaaaaaaaaaaaaaaaaaaaaaaaa
aaaaaaaaaaaaaaaaaaaaaaaaaaaaaaaaaaaaaaaaaaaaaaaaaaaaaaaaaaaaaaaaaaaaaaaaaaaaaaaaaaaaaaaaaaaaaaaaaaaaaaaaaaaaaaaaaaaaaaaaaaaaa
"}
