"a" = (/turf/UnbreakableTurfs/Void_Wall,/area/Outside)
"b" = (/turf/Other/Blank,/area/Outside)
"c" = (/turf/Other/Blank,/area/dungeon_area)
"d" = (/turf/UnbreakableTurfs/Void_Wall,/area/dungeon_area)
"e" = (/turf/Stairs1,/area/dungeon_area)
"f" = (/obj/dungeon_exit,/turf/Stairs1,/area/dungeon_area)
"g" = (/turf/Ground/Ground10,/area/dungeon_area)
"h" = (/mob/npc/Enemy/Tiger_Bandit,/turf/Ground/Ground10,/area/dungeon_area)
"i" = (/turf/Water3,/area/dungeon_area)
"j" = (/obj/Boat{SaveItem = 0},/turf/Water3,/area/dungeon_area)
"k" = (/obj/items/Smoke_Bomb,/turf/Ground/Ground10,/area/dungeon_area)
"l" = (/obj/items/Rebreather,/turf/Ground/Ground10,/area/dungeon_area)
"m" = (/obj/items/Research_Book{IntPower = 50},/turf/Ground/Ground10,/area/dungeon_area)
"n" = (/mob/npc/Enemy/Bandit,/turf/Ground/Ground10,/area/dungeon_area)
"o" = (/obj/items/food/Fish,/turf/Ground/Ground10,/area/dungeon_area)
"p" = (/obj/items/food/Yemma_Fruit,/turf/Ground/Ground10,/area/dungeon_area)
"q" = (/mob/npc/Enemy/Bosses/Golem,/turf/Ground/Ground10,/area/dungeon_area)
"r" = (/turf/Door/Door5{password = "BDOOR412"},/area/dungeon_area)
"s" = (/mob/npc/Enemy/Bosses/Lost_Soldier,/turf/Ground/Ground10,/area/dungeon_area)
"t" = (/mob/npc/Enemy/Bosses/Nauscent_Immortal,/turf/Ground/Ground10,/area/dungeon_area)
"u" = (/obj/items/Equipment/Weapon/Hammer/Warhammer,/turf/Ground/Ground10,/area/dungeon_area)
"v" = (/obj/items/food/Apple_Of_Eden,/turf/Ground/Ground10,/area/dungeon_area)
"w" = (/obj/items/Guns/Rocket_Launcher,/turf/Ground/Ground10,/area/dungeon_area)
"x" = (/turf/Stairs4,/area/dungeon_area)
"y" = (/obj/items/Key{password = list("BDOOR412')")},/turf/Ground/Ground10,/area/dungeon_area)
"z" = (/obj/items/Anti_Virus/Anti_Virus_Delta,/turf/Ground/Ground10,/area/dungeon_area)
"A" = (/obj/Zenni{name = "125000 Zenni"; zenni = 125000},/turf/Ground/Ground10,/area/dungeon_area)
"B" = (/obj/dungeon_exit{isClearingExit = 1},/turf/Stairs4,/area/dungeon_area)

(1,1,1) = {"
aaaaaaaaaaaaaaaaaaaaaaaaaaaaaaaaaaaaaaaaaaaaaaaaaaaaaaaaaaaaaaaaaaaaaaaaaaaaaaaaaaaaaaaaaaaaaaaaaaaaaaaaaaaaaaaaaaaaaaaaaaaaa
aaaaaaaaaaaaaaaaaaaaaaaaaaaaaaaaaaaaaaaaaaaaaaaaaaaaaaaaaaaaaaaaaaaaaaaaaaaaaaaaaaaaaaaaaaaaaaaaaaaaaaaaaaaaaaaaaaaaaaaaaaaaa
aaaaaaaaaaaaaaaaaaaaaaaaaaaaaaaaaaaaaaaaaaaaaaaaaaaaaaaaaaaaaaaaaaaaaaaaaaaaaaaaaaaaaaaaaaaaaaaaaaaaaaaaaaaaaaaaaaaaaaaaaaaaa
aaabbbbbbbbbbbbbbbbbbbbbbbbbbbccccccccccccccccccccccdeeedccccccccccccccccccccccccccccccccccccccccccccccccccccccccccccccccbaaa
aaabbbbbbbbbbbbbbbbbbbbbbbbbbbccccccccccccccccccccccdefedcccdddccccccccccccccccccccccccccccccccccccccccccccccccccccccccccbaaa
aaabbbbbbbbbbbbbbbbbbbbbbbbbbbccccccccccccccccdddddcdeeedcdddgddddcccccccccccccccccccccccccccccccccccccccccccccccccccccccbaaa
aaabbbbbbbbbbbbbbbbbbbbbbbbbbbcccccccccccccccddgggdddeeedddggggggdddcccccccccccccccccccccccccccccccccccccccccccccccccccccbaaa
aaabbbbbbbbbbbbbbbbbbbbbbbbbbbcccccccccccccccdggggggggggggggggggggddcccccccccccccccccccccccccccccccccccccccccccccccccccccbaaa
aaabbbbbbbbbbbbbbbbbbbbbbbbbbbccccccccccccccddggggggggggggggggggggdccccccccccccccccccccccccccccccccccccccccccccccccccccccbaaa
aaabbbbbbbbbbbbbbbbbbbbbbbbbbbcccccccccccccddgggggggggggggggggggggdccccccccccccccccccccccccccccccccccccccccccccccccccccccbaaa
aaabbbbbbbbbbbbbbbbbbbbbbbbbbbcccccccccccccdggggggggggggggggggggggdddccccccccccccccccccccccccccccccccccccccccccccccccccccbaaa
aaabbbbbbbbbbbbbbbbbbbbbbbbbbbcccccccccccccdddggggggggggggggggggggggddddddddddccddddddddcccccccccccccccccccccccccccccccccbaaa
aaabbbbbbbbbbbbbbbbbbbbbbbbbbbcccccccccccccccddgggggggggggggggggggggggggggggdcccdggggggddccccccccccccccccccccccccccccccccbaaa
aaabbbbbbbbbbbbbbbbbbbbbbbbbbbcccccccccccccccdggggggggggggggggggggggggggggggdddcdggghggddccccccccccccccccccccccccccccccccbaaa
aaabbbbbbbbbbbbbbbbbbbbbbbbbbbcccccccccccccccdgggggggggggggggggggggggddggggggggddggggggdddddddddddddddddddddddddddddddcccbaaa
aaabbbbbbbbbbbbbbbbbbbbbbbbbbbcccccccccccccccdgggggggggggggggggggggggddggggggggggghggggggggggggggggggggggggggggggggggdcccbaaa
aaabbbbbbbbbbbbbbbbbbbbbbbbbbbcccccccccccccccddddgggggggggggggggggggggddddggggggggggddgggggggggggggggggggggggggggggggdcccbaaa
aaabbbbbbbbbbbbbbbbbbbbbbbbbbbcccccccccccccccccddddggggggdgggggggdgdddddddddddddddddddggggggggggggggggggggggggggggiggdcccbaaa
aaabbbbbbbbbbbbbbbbbbbbbbbbbbbccccccccccccccccccccddgggdddddgggdddddccccccccccccccccddgggggggiiiggggggggggggggggggiggdcccbaaa
aaabbbbbbbbbbbbbbbbbbbbbbbbbbbcccccccccccccccccccccdgggdcccdddddccccccccccccccccccccddiiiiiiiiiiiiiiijiiiiiiiiiiiiiiidcccbaaa
aaabbbbbbbbbbbbbbbbbbbbbbbbbbbcccccccccccccccccccccdgggdccccccccccccccccccccccccccccddiiiiiiiiiiiiiiiiiiiiiiiiiiiiiiidcccbaaa
aaabbbbbbbbbbbbbbbbbbbbbbbbbbbccccdddddddddddddccccdgggdccccccccccccccccccccccccccccddiiiiiiiiiiiiiiiiiiiiiiiiiiiiiiidcccbaaa
aaabbbbbbbbbbbbbbbbbbbbbbbbbbbccccdggggggggggddccccdgggdccccccccccccccccccccccccccccddiiiiiiiiiiiiiiiiiiiiiiiiiiiiiiidcccbaaa
aaabbbbbbbbbbbbbbbbbbbbbbbbbbbccccdggghgkggggddccccdgggdccccccccccccccccccccccccccccddiiiiiiiiiiiiiiiiiiiiiiiiiiiiiiidcccbaaa
aaabbbbbbbbbbbbbbbbbbbbbbbbbbbccccdggggkgkgggddccccdgggdccccccccccccccccccccccccccccddiiiiiiiiiiiiiiiiiiiiiiiiiiiiiiidcccbaaa
aaabbbbbbbbbbbbbbbbbbbbbbbbbbbccccdgggggghgggddccccdgggdccccccccccccccccccccccccccccddgggiiiiiiiiiiiiiiiiiiiiiiiiiiiidcccbaaa
aaabbbbbbbbbbbbbbbbbbbbbbbbbbbccccdggggggggggddccccdgggdccccccccccccccccccccccccccccddgggjiiiiiiiiiiiiiiiiiiiiiiiiiiidcccbaaa
aaabbbbbbbbbbbbbbbbbbbbbbbbbbbccccdggggggggggddccccdghgdccccccccccccccccccccccccccccddgggiiiiiiiiiiigggiiiiiiiiiiiiiidcccbaaa
aaabbbbbbbbbbbbbbbbbbbbbbbbbbbccccddddggddddddddddddgggddddddddddddddddcccccccccccccddiiiiiiiiiiiiiiggggiiiiiiiiiiiiidcccbaaa
aaabbbbbbbbbbbbbbbbbbbbbbbbbbbcccccccdggdgggggggggggggggggggggggggggggdddddcccccccccddiiiiiiiiiiiiiiggggiiiiiiiiiiiiidcccbaaa
aaabbbbbbbbbbbbbbbbbbbbbbbbbbbcccccccddgggggggggggggggggggggggggggggggggggdddcccccccddiiiiiiiiiiiiiiigggggiiiiiiiiiigdcccbaaa
aaabbbbbbbbbbbbbbbbbbbbbbbbbbbccccccccddgggdddddddddgggddddddgggghggggggggggddccccccddiiiiiiiiiiiiiiiggiiiiiiiiiiiiigdcccbaaa
aaabbbbbbbbbbbbbbbbbbbbbbbbbbbcccccccccdgggggdccccddgggddcccdggggggggggghgggddccccccddiiiiiiiiiiiiiiiiiiiiiiiiiiiiiigdcccbaaa
aaabbbbbbbbbbbbbbbbbbbbbbbbbbbcccccccccdglgggdddccddgggddcccdgggggggggggggggddccccccddiiiiiiiiiiiiiiiiiiiiiiiiiiiiiigdcccbaaa
aaabbbbbbbbbbbbbbbbbbbbbbbbbbbcccccccccdggghgggdccddgggddcccdgggggggggddddddddccccccddiiiiiiiiiiiiiiiiiiiiiiiiiiiiiggdcccbaaa
aaabbbbbbbbbbbbbbbbbbbbbbbbbbbcccccccccddddggggdccddgggddcccdddddddddddddcccccccccccddiiiiiiiiiiiiiiiiiiiiiiiiiiiigggdcccbaaa
aaabbbbbbbbbbbbbbbbbbbbbbbbaddddddddddddddddddddddddgggdddddddddddddddddddddddddccccddgggiiiiiiiiiiiiiiiiiiiiiiiiiiggdcccbaaa
aaabbbbbbbbbbbbbbbbbbbbbbbbadggggggggggggggggggggggggggggggggggggggggggggggggggdccccddgggiiiigiiiiiiiiiiiiiiiiiiiiiggdcccbaaa
aaabbbbbbbbbbbbbbbbbbbbbbbbadggggggggggggggggggggggghggggggggggggggggggggggggggdccccddgggiiigggiiiiiiiiiiiiiiiiiiigggdcccbaaa
aaabbbbbbbbbbbbbbbbbbbbbbbbadgghgggggggggggggggggggggggggggggiiiiiiiigiiiiiiiggdccccddgggiigghggiiiiiiiiiiiiiiiiiiiggdcccbaaa
aaabbbbbbbbbbbbbbbbbbbbbbbbadggggiiiiiiiiiiiiiiiiiiiijiiiiiiiiiiiiiiiiiiiiiiiigdccccddgggiiiggiiiiiiiiiiiiiiiiiiiiiggdcccbaaa
aaabbbbbbbbbbbbbbbbbbbbbbbbadgggiiiiiiiiiiiiiiiiiiiiiiiiiiiiiiiiiiiiiiiiiiiiiigdccccddgggiiiigiiiiiiiiiiiiiiiiiiiiiiidcccbaaa
aaabbbbbbbbbbbbbbbbbbbbbbbbadgggiiiiiiiiiiiiiiiiiiiiiiiiiiiiiiiiiiiiiiiiiiiiiigdccccddgggiiiiiiiiiiiiiiiiiiiiiiiiiiiidcccbaaa
aaabbbbbbbbbbbbbbbbbbbbbbbbadggiiiiiiiiiiiiiiiiiiiiiiiiiiiiiiiiiiiiiiiiiiiiiiigdccccddgiiiiiiiiiiiiiiiiiiiiiiiiiiiiiidcccbaaa
aaabbbbbbbbbbbbbbbbbbbbbbbbadggjiiiiiiiiiiiiiiiiiiiiiiiiiiiiiiiiiiiiiiiiiiiiiigdccccddgiiiiiiiiiiiiiiiiiiiiiiiiiiiiiidcccbaaa
aaabbbbbbbbbbbbbbbbbbbbbbbbadgggiiiiiiiiiiiiiiiiiiiiiiiiiiiiiiiiiiiiiiiiiiiiiigdccccddgiiiiiiiiiiiiiiiiiiiiiiiiiiiiigdcccbaaa
aaabbbbbbbbbbbbbbbbbbbbbbbbadggiiiiiiiiiiiiiiiiiiiiiiiiiiiiiiiiiiiiiiiiiiiiiiigdccccddiiiiiiiiiiiiiiiiiiiiiiiiiiiiiigdcccbaaa
aaabbbbbbbbbbbbbbbbbbbbbbbbadgiiiiiiiiiiiiiiiiiiiiiiiiiiiiiiiiiiiiiiiiiiiiiiiiidccccddiiiiiiiiiiiiiiiiiiiiiiiiiiiiiigdcccbaaa
aaabbbbbbbbbbbbbbbbbbbbbbbbadiiiiiiiiiiiiiiiiiiiiiiiiiiiiiiiiiiiiiiiiiiiiiiiiiidccccddiiiiiiiiiiiiiiiiiiiiiiiiiiiigggdcccbaaa
aaabbbbbbbbbbbbbbbbbbbbbbbbadiiiiiiiiiiiiiggigiiiiiiiiiiiiiiiiiiiiiiiiiiiiiiiiidccccddiiiiiiiiiiiiiiiiiiiiiiiiiiiigggdcccbaaa
aaabbbbbbbbbbbbbbbbbbbbbbbbadiiiiiiiiiiiiigggiiiiiiiiiiiiiiiiiiiiiiiiiiiiiiiiiidccccddgiiiiiiiiiiiiiiiiiiiiiiiiiiigggdcccbaaa
aaabbbbbbbbbbbbbbbbbbbbbbbbadiiiiiiiiiiiigggggiiiiiiiiiiiiiiiiiiiiiiiiiiiiiiiiidccccddgiiiiiiiiiiiiiiiiiiiiiiiiiiigghdcccbaaa
aaabbbbbbbbbbbbbbbbbbbbbbbbadiiiiiiiiiiiiigggigiiiiiiiiiiiiiiiiiiiiiiiiiiiiiiiidccccddgiiiiiiiiiiiiiiiiiiiiiiiiiiigggdcccbaaa
aaabbbbbbbbbbbbbbbbbbbbbbbbadiiiiiiiiiiiiiiiiiiiiiiiiiiiiiiiiiiiiiiiiiiiiiiiiiidccccddgggiiiiiiiiiiiiiiiiiiiiiiiiigggdcccbaaa
aaabbbbbbbbbbbbbbbbbbbbbbbbadiiiiiiiiiiiiiiiiiiiiiiiiiiiiiiiiiiiiiiiiiiiiiiiiiidccccddgggiiiiiiiiiiiiiiiiiiiiiiiiigggdcccbaaa
aaabbbbbbbbbbbbbbbbbbbbbbbbadiiiiiiiiiiiiiiiiiiiiiiiiiiiiiiiiiiiiiiiiiiiiiiiiiidccccddgggiiiiiiiiiiiiiiiiiiiiiiiiigggdcccbaaa
aaabbbbbbbbbbbbbbbbbbbbbbbbadiiiiiiiiiiiiiiiiiiiiiiiiiiiiiiiiiiiiiiiiiiiiiiiiiidccccddgmgiiiiiiiiiiiiiiiiiiiiiiiiigggdcccbaaa
aaabbbbbbbbbbbbbbbbbbbbbbbbadiiiiiiiiiiiiiiiiiiiiiiiiiiiiiiiiiiiiiiiiiiiiiiiiiidccccddgggiiiiiiiiiiiiiiiiiiiiiiiiigggdcccbaaa
aaabbbbbbbbbbbbbbbbbbbbbbbbadiiiiiiiiiiiiiiiiiiiiiiiiiiiiiiiiiiiiiiiiiiiiiiiiiidccccddgggiiiiiiiiiiiiiiiiiiiiiiiiiiiidcccbaaa
aaabbbbbbbbbbbbbbbbbbbbbbbbadiiiiiiiiiiiiiiiiiiiiiiiiiiiiiiiiiiiiiiiiiiiiiiiiiidccccddgggiiiiiiiiiiiiiiiiiiiiiiiiiiiidcccbaaa
aaabbbbbbbbbbbbbbbbbbbbbbbbadiiiiiiiiiiiiiiiiiiiiiiiiiiiiiiiiiiiiiiiiiiiiiiiiiidccccddgiiiiiiiiiiiiiiiiiiiiiiiiiiiiiidcccbaaa
aaabbbbbbbbbbbbbbbbbbbbbbbbadiiiiiiiiiiiiiiiiiiiiiiiiiiiiiiiiiiiiiiiiiiiiiiiiiidccccddgiiiiiiiiiiiiiiiiiiiiiiiiiiiiiidcccbaaa
aaabbbbbbbbbbbbbbbbbbbbbbbbadiiiiiiiiiiiiiiiiiiiiiiiiiiiiiiiigiiiiiiiiiiiiiiiiidccccddgiiiiiiiiiiiiiiiiiiiiiiiiiiiiiidcccbaaa
aaabbbbbbbbbbbbbbbbbbbbbbbbadiiiiiiiiiiiiiiiiiiiiiiiiiiiiigigggiiiiiiiiiiiiiiiidccccddiiigggiiiiiiiiiiiiiiiiiiiiiiiiidddcbaaa
aaabbbbbbbbbbbbbbbbbbbbbbbbadiiiiiiiiiiiiiiiiiiiiiiiiigggggggggiiiiiiiiiiiiiiiidccccddiiigggiiiiiiiiiiiiiiiiiiiiiiiiiggdcbaaa
aaabbbbbbbbbbbbbbbbbbbbbbbbadiiiiiiiiiiiiiiiiiiiiiiiiiggiggggggggiiiiiiiiiiiiiidccccddiiiiiiiiiiiiiiiiiiiiiiiiiiiiiigggdcbaaa
aaabbbbbbbbbbbbbbbbbbbbbbbbadiiiiiiiiiiiiiiiiiiiiiiiiigigggnnggggiiiiiiiiiiiiiidccccddgiiiiiiiiiiiiiiiiiiiiiiiiiiiiigiidcbaaa
aaabbbbbbbbbbbbbbbbbbbbbbbbadiiiiiiiiiiiiiiiiiiiiiiiiiiiggogggggiiiiiiiiiiiigggdccccdddddddgiiiiiiiiiiiiiiiiiiiiiiiiiiiddbaaa
aaabbbbbbbbbbbbbbbbbbbbbbbbadiiiiiiiiiiiiiiiiiiiiiiiiiiiigggngggiiiiiiiiiiiigggddddcccdddddggggiiiiiiiiiiiiiiiiiiiiiiiigdbaaa
aaabbbbbbbbbbbbbbbbbbbbbbbbadiiiiiiiiiiggggiiiiiiiiiiiiiiggggggiiiiiiiiiiiiiggggggdcccccccddgggggggggiiiigggiiiiiiiiiiigdbaaa
aaabbbbbbbbbbbbbbbbbbbbbbbbadiiiiiiiggngnggiiiiiiiiiiiiiiiigggiiiiiiiiiiiiiiggggggddddccccddgggggggggiiiigggiiiiiiiiiiigdbaaa
aaabbbbbbbbbbbbbbbbbbbbbbbbadiiiiiiiggggngggiiiiiiiiiiiiiiiiiiiiiiiiiiiiiiiiiigggggngddcccddddddddddddddigggiiiiiiiiiiigdbaaa
aaabbbbbbbbbbbbbbbbbbbbbbbbadiiiiiiiggggggggiiiiiiiiiiiiiiiiiiiiiiiiiiiiiiiiiigdgggggddccccdddddddddddddiiiiiiiiiiiiiiigdbaaa
aaabbbbbbbbbbbbbbbbbbbbbbbbadiiiiiiiigigggggiiiiiiiiiiiiiiiiiiiiiiiiiiiiiiiiiiidggnhgddcccccccccccccccddiiiiiiiiiiiiiiigdbaaa
aaabbbbbbbbbbbbbbbbbbbbbbbbadiiiiiiiiiiggggiiiiiiiiiiiiiiiiiiiiiiiiiiiiiiiiiiiidgggggddddddddddddccccddddddiiiiiiiiiiiigdbaaa
aaabbbbbbbbbbbbbbbbbbbbbbbbadiiiiiiiiiiiiiiiiiiiiiiiiiiiiiiiiiiiiiiiiiiiiiiiiiiddddggddgggggggggddddddddddddiiiiiiiiiiigdbaaa
aaabbbbbbbbbbbbbbbbbbbbbbbbadiiiiiiiiiiiiiiiiiiiiiiiiiiiiiiiiiiiiiiiiiiiiiiiiiidccdggddgggggggggddddddddddddiiiiiiiiiiiidbaaa
aaabbbbbbbbbbbbbbbbbbbbbbbbadiiiiiiiiiiiiiiiiiiiiiiiiiiiiiiiiiiiiiiiiiiiiiiiiiidccddgddggggggggggggggggggdddiiiiiiiiiiiidbaaa
aaabbbbbbbbbbbbbbbbbbbbbbbbadiiiiiiiiiiiiiiiiiiiiiiiiiiiiiiiiiiiiiiiiiiiiiiiiiidcccdgggggggggggggggggggggdddiiiiiiiiiiiidbaaa
aaabbbbbbbbbbbbbbbbbbbbbbbbadiiiiiiiiiiiiiiiiiiiiiiiiiiiiiiiiiiiiiiiiiiiiiiigggdcccdgggggggggggggggggggggdddiiiiiiiiiiggdbaaa
aaabbbbbbbbbbbbbbbbbbbbbbbbadiiiiiiiiiiiiiiiiiiiiiiiiiiiiiiiiiiiiiiiiiiiiiiigggdcccddddddggggggggggggggggdddiiiiiiiiiiggdbaaa
aaabbbbbbbbbbbbbbbbbbbbbbbbadiiiiiiiiiiiiiiiiiiiiiiiiiiiiiiiiiiiiiiiiiiiiiiigggdccccccccdggggggggggggggggdddiiiiiiiiiidddbaaa
aaabbbbbbbbbbbbbbbbbbbbbbbbadiiiiiiiiiiiiiiiiiiiiiiiiiigiiiiiiiiiiiiiiiiiiiiiiidccccccccdggggggggggggggggdddgiiiiiiiigdccbaaa
aaabbbbbbbbbbbbbbbbbbbbbbbbadiiiiiiiiiiiiiiiiiiiiiiiiggggiiiiiiiiiiiiiiiiiiiiiidccccccccdggggogggggggggggdddggiiiiiiggdccbaaa
aaabbbbbbbbbbbbbbbbbbbbbbbbadiiiiiiiiiiiiiiiiiiiiiiigggoggiiiiiiiiiiiiiiiiiiiigdccccccccdggggggggggpgggggdddggggggggggdccbaaa
aaabbbbbbbbbbbbbbbbbbbbbbbbadiiiiiiiiiiiiiiiiiiiiiiggggggggiiiiiiiiiiiiiiiiiiigdccccccccdgggggggqggggggggdddggggggggggdccbaaa
aaabbbbbbbbbbbbbbbbbbbbbbbbadiiiiiiiiiiiiiiiiiiiiiigggghggggiiiiiiiiiiiiiiiiiigdccccccccdggggggggggggggggdddggggggggggdccbaaa
aaabbbbbbbbbbbbbbbbbbbbbbbbadiiiiiiiiiiiiiiiiiiiiiiggghggggggiiiiiiiiiiiiiiiiigdccccccccdggggggggggggggggdddggggggggggdccbaaa
aaabbbbbbbbbbbbbbbbbbbbbbbbadiiiiiiggggiiiiiiiiiiiiggggggggiiiiiiiiiiiiiiiiiiigdccccccccdggggggggggggggggdddggngggggggdccbaaa
aaabbbbbbbbbbbbbbbbbbbbbbbbadiiiiiiggggiiggiiiiiiiiiggggggiiiiiiiiiiiiiiiiiiiigdccccccccdggggggggggggggggdddgggggggggdddcbaaa
aaabbbbbbbbbbbbbbbbbbbbbbbbadiiiiiggggggiggiiiiiiiiiiiggggiiiiiiiiiiiiiiiiiiiigdccccccccdggggggggggggggggdddggggggnggggdcbaaa
aaabbbbbbbbbbbbbbbbbbbbbbbbadiiiiigghhgggoiiiiiiiiiiiiiiiiiiiiiiiiiiiiiiiiiiiigdccccccccdggggggggggggggggdddgggggggggggdcbaaa
aaabbbbbbbbbbbbbbbbbbbbbbbbadiiiiigghggggggiiiiiiiiiiiiiiiiiiiiiiiiiiiiiiiiiiiidccccccccdggggggggggggggggddggggggggggggdcbaaa
aaabbbbbbbbbbbbbbbbbbbbbbbbadiiiiigggggggiiiiiiiiiiiiiiiiiiiiiiiiiiiiiiiiiiiiiidccccccccdggggggggggggggggddgggghgggggggddbaaa
aaabbbbbbbbbbbbbbbbbbbbbbbbadiiiiiiggggiiiiiiiiiiiiiiiiiiiiiiiiiiiiiiiiiiiiiiiidccccccccdggggggggggggggggddgggggggggggggdbaaa
aaabbbbbbbbbbbbbbbbbbbbbbbbadiiiiiiiggggiiiiiiiiiiiiiiiiiiiiiiiiiiiiiiiiiiiiiiidccccccccdddddddddddggggddddgggggggggggggdbaaa
aaabbbbbbbbbbbbbbbbbbbbbbbbadiiiiiiiiiiiiiiiiiiiiiiiiiiiiiiiiiiiiiiiiiiiiiiiiiidccccccccccccccccccdggggddddggggggnggggggdbaaa
aaabbbbbbbbbbbbbbbbbbbbbbbbadiiiiiiiiiiiiiiiiiiiiiiiiiiiiiiiiiiiiiiiiiiiiiiiiiidccccccccccccccccccdggggddddggnggggggggggdbaaa
aaabbbbbbbbbbbbbbbbbbbbbbbbadiiiiiiiiiiiiiiiiiiiiiiiiiiiiiiiiiiiiiiiiiiiiiiiiiidccccccccccccccccdddggggddddgggggggggggggdbaaa
aaabbbbbbbbbbbbbbbbbbbbbbbbadiiiiiiiiiiiiiiiiiiiiiiiiiiiiiiiiiiiiiiiiiiiiiiiiiidccccccccccccccccdddggggddddgggggggggggggdbaaa
aaabbbbbbbbbbbbbbbbbbbbbbbbadiiiiiiiiiiiiiiiiiiiiiiiiiiiiiiiiiiiiiiiiiiiiiiiiiidccccccccccccccdddggggggddddgggggggggggggdbaaa
aaabbbbbbbbbbbbbbbbbbbbbbbbadiiiiiiiiiiiiiiiiiiiiiiiiiiiiiiiiiiiiiiiiiiiiiiiiiidccccccccccccccdddgggdddddddgggggghggggggdbaaa
aaabbbbbbbbbbbbbbbbbbbbbbbbadiiiiiiiiiiiiiiiiiiiiiiiiiiiiiiiiiiiiiiiiiiiiiiiiiidcccccccccccccddgggggdddddddgggggggggggggdbaaa
aaabbbbbbbbbbbbbbbbbbbbbbbbadiiiiiiiiiiiiiiiiiiiiiiiiiiiiiiiiiiiiiiiiiiiiiiiiiidcccccccccccccddgggggdddgggggggggggggggggdbaaa
aaabbbbbbbbbbbbbbbbbbbbbbbbadiiiiiiiiiiiiiiiiiiiiiiiiiiiiiiiiiiiiiiiiiiiiiiiiiidcccccccccccccddgggggdddgggggggggggggggggdbaaa
aaabbbbbbbbbbbbbbbbbbbbbbbbadiiiiiiiiiiiiiiiiiiiiiiiiiiiiiiiiiiiiiiiiiiiiiiiiiidcccccccccccccddgggggddggggggggggggggngggdbaaa
aaabbbbbbbbbbbbbbbbbbbbbbbbadiiiiiiiiiiiiiiiiiiiiiiiiiiiiiiiiiiiiiiiiiiiiiiiiiidcccccccccccccddgggggddggggggggggggggggggdbaaa
aaabbbbbbbbbbbbbbbbbbbbbbbbadiiiiiiiiiiggggggggggggggggggggggggiiiiiiiiiiiiiiiidcccccccccccccddgnghgddggggggggggggggggggdbaaa
aaabbbbbbbbbbbbbbbbbbbbbbbbadiiiiiiiiiigggggggggghggggggggggggggiiiiiiiiiiiiiiidcccccccccccddddggnggddggggggggggggggggggdbaaa
aaabbbbbbbbbbbbbbbbbbbbbbbbadiiiiiiiiiggggggggggggggggggggggghgggiiiiiiiiiiiiiidcccccccccccddddgggggddggggggggggggggggggdbaaa
aaabbbbbbbbbbbbbbbbbbbbbbbbadiiiiiiiiggddddddddddddgdddddddddddggiiiiiiiiiiiiiidcccccccccccddddgggggdddgggggggggggggggggdbaaa
aaabbbbbbbbbbbbbbbbbbbbbbbbadiiiiiiiiggddddddddddddrdddddddddddgggiiiiiiiiiiiiidddddddddddddgggggdddddggggggggggggggggggdbaaa
aaabbbbbbbbbbbbbbbbbbbbbbbbadgiiiiiiigdddgggggggggggggggggggdddgggiiiiiiiiiiiggdddddddddddddgggggdddddggggggggggggggggggdbaaa
aaabbbbbbbbbbbbbbbbbbbbbbbbadggiiiiiigdddgggggggggggggggggggdddggggiiiiiiiiiiggggggggggggggggggggdddddggggggggggggggggggdbaaa
aaabbbbbbbbbbbbbbbbbbbbbbbbadgggggggggdddgggggggggggggggggggdddggggiiiiiiiiiiggggggggggggggggggdddddggggggggggggggggggggdbaaa
aaabbbbbbbbbbbbbbbbbbbbbbbbadgggggggggdddgggggggggggggggggggdddggggiiiiiiiiigggdddddddddddddddddddddggggggggggggsgggggggdbaaa
aaabbbbbbbbbbbbbbbbbbbbbbbbadgggggggggdddggggggggggtggggggggdddgggggiiiiiigggggdddddddddddddddddddddggggggggggggggggggggdbaaa
aaabbbbbbbbbbbbbbbbbbbbbbbbadgggggggggdddgggggggggguggggggggdddggggggggggggggggdddddddddddddddddddggggggggggggggggggggggdbaaa
aaabbbbbbbbbbbbbbbbbbbbbbbbadgggggggggdddgggggggggggvgggggggdddggggggggggggggggdddggwgggggggggggggggggggggggggggggggggggdbaaa
aaabbbbbbbbbbbbbbbbbbbbbbbbadddddddddddddddddddddddddxxxddddddddddddddddddddddddddgyggzggAggggggggggggggggggggggggggggggdbaaa
aaabbbbbbbbbbbbbbbbbbbbbbbbbbbccccccccdddddddddddddddxxxddddddddddddddddddddddddddggvgggggggggggggggggggggggggggggggggggdbaaa
aaabbbbbbbbbbbbbbbbbbbbbbbbbbbccccccccdddddddddddddddxBxdddddddddddddddddddddddddddddddddddddddddddddddddddddddddddddddddbaaa
aaaaaaaaaaaaaaaaaaaaaaaaaaaaaaaaaaaaaaaaaaaaaaaaaaaadddddaaaaaaaaaaaaaaaaaaaaaaaaaaaaaaaaaaaaaaaaaaaaaaaaaaaaaaaaaaaaaaaaaaaa
aaaaaaaaaaaaaaaaaaaaaaaaaaaaaaaaaaaaaaaaaaaaaaaaaaaaaaaaaaaaaaaaaaaaaaaaaaaaaaaaaaaaaaaaaaaaaaaaaaaaaaaaaaaaaaaaaaaaaaaaaaaaa
aaaaaaaaaaaaaaaaaaaaaaaaaaaaaaaaaaaaaaaaaaaaaaaaaaaaaaaaaaaaaaaaaaaaaaaaaaaaaaaaaaaaaaaaaaaaaaaaaaaaaaaaaaaaaaaaaaaaaaaaaaaaa
"}
