"a" = (/turf/UnbreakableTurfs/Void_Wall,/area/Outside)
"b" = (/turf/Other/Blank,/area/Outside)
"c" = (/turf/Stairs1,/area/Outside)
"d" = (/obj/dungeon_exit,/turf/Stairs1,/area/Outside)
"e" = (/turf/Stairs4,/area/Outside)
"f" = (/obj/dungeon_exit{isClearingExit = 1},/turf/Stairs4,/area/Outside)
"g" = (/turf/RoofWhite,/area/Outside)
"h" = (/turf/CastleFloor/Pyramid,/area/Outside)
"i" = (/mob/npc/Enemy/Zombie,/turf/CastleFloor/Pyramid,/area/Outside)
"j" = (/mob/npc/Enemy/Decaying_Skeleton,/turf/CastleFloor/Pyramid,/area/Outside)
"k" = (/obj/Container/Chest,/turf/CastleFloor/Pyramid,/area/Outside)
"l" = (/obj/buildables/Fire,/turf/Grass/Grass10,/area/Outside)
"m" = (/mob/npc/Enemy/Mindless_Lich,/turf/CastleFloor/Pyramid,/area/Outside)
"n" = (/mob/npc/Enemy/Bosses/Master_Of_Zombies,/turf/CastleFloor/Pyramid,/area/Outside)
"o" = (/obj/Artifacts/Boosters/Willpower_Gem,/turf/CastleFloor/Pyramid,/area/Outside)
"p" = (/mob/npc/Enemy/Bosses/Vampiric_Immortal,/turf/CastleFloor/Pyramid,/area/Outside)
"q" = (/obj/SacredGroveGate,/turf/CastleFloor/Pyramid,/area/Outside)
"r" = (/mob/npc/Enemy/Bosses/Lich,/turf/CastleFloor/Pyramid,/area/Outside)
"s" = (/mob/npc/Enemy/Bosses/Alarato_Lich,/turf/CastleFloor/Pyramid,/area/Outside)
"t" = (/obj/Artifacts/Blood_Chalice,/turf/CastleFloor/Pyramid,/area/Outside)
"u" = (/obj/items/Dungeon_Needle,/turf/CastleFloor/Pyramid,/area/Outside)
"v" = (/obj/items/Clawed_Talisman,/turf/CastleFloor/Pyramid,/area/Outside)
"w" = (/obj/items/Bio_Field,/turf/Other/Blank,/area/Outside)
"x" = (/obj/items/Bandages,/turf/CastleFloor/Pyramid,/area/Outside)
"y" = (/obj/items/Omniwatch,/turf/CastleFloor/Pyramid,/area/Outside)
"z" = (/obj/items/Anti_Virus/Anti_Virus_Daybreaker,/turf/CastleFloor/Pyramid,/area/Outside)
"A" = (/obj/items/food/Apple_Of_Eden,/turf/CastleFloor/Pyramid,/area/Outside)
"B" = (/obj/items/Infinity_Stone_Holder,/turf/CastleFloor/Pyramid,/area/Outside)

(1,1,1) = {"
aaaaaaaaaaaaaaaaaaaaaaaaaaaaaaaaaaaaaaaaaaaaaaaaaaaaaaaaaaaaaaaaaaaaaaaaaaaaaaaaaaaaaaaaaaaaaaaaaaaaaaaaaaaaaaaaaaaaaaaaaaaaa
aaaaaaaaaaaaaaaaaaaaaaaaaaaaaaaaaaaaaaaaaaaaaaaaaaaaaaaaaaaaaaaaaaaaaaaaaaaaaaaaaaaaaaaaaaaaaaaaaaaaaaaaaaaaaaaaaaaaaaaaaaaaa
aaaaaaaaaaaaaaaaaaaaaaaaaaaaaaaaaaaaaaaaaaaaaaaaaaaaaaaaaaaaaaaaaaaaaaaaaaaaaaaaaaaaaaaaaaaaaaaaaaaaaaaaaaaaaaaaaaaaaaaaaaaaa
aaabbbbbbbbbbbbbbbbbbbbbbbbbbbbbbbbbbbbbbbbbbbbbbbbggcccggbbbbbbbbbbbbbbbbbbbbbbbbbbbbbbbbbbbbbbbbbbbbbbbbbbbbbbbbbbbbbbbbaaa
aaabbbbbbbbbbbbbbbbbbbbbbbbbbbbbbbbbbbbbbbbbbbbbbbbggcdcggbbbbbbbbbbbbbbbbbbbbbbbbbbbbbbbbbbbbbbbbbbbbbbbbbbbbbbbbbbbbbbbbaaa
aaabbbbbbbbbbbbbbbbbbbbbbbbbbbbbbbbbbbbbbbbbbbbbbbbggcccggbbbbbbbbbbbbbbbbbbbbbbbbbbbbbbbbbbbbbbbbbbbbbbbbbbbbbbbbbbbbbbbbaaa
aaabbbbbbbbbbbbbbbbbbbbbbbbbbbbbbbbbbbbbbbbbbbbggggggcccggggggbbbbbbbbbbbbbbbbbbbbbbbbbbbbbbbbbbbbbbbbbbbbbbbbbbbbbbbbbbbbaaa
aaabbbbbbbbbbbbbbbbbbbbbbbbbbbbbbbbbbbbbbbbbbbbgggggghhhggggggbbbbbbbbbbbbbbbbbbbbbbbbbbbbbbbbbbbbbbbbbbbbbbbbbbbbbbbbbbbbaaa
aaabbbbbbbbbbbbbbbbbbbbbbbbbbbbbbbbbbbbbbbbbbbbgghhhhhhhhhhhggbbbbbbbbbbbbbbbbbbbbbbbbbbbbbbbbbbbbbbbbbbbbbbbbbbbbbbbbbbbbaaa
aaabbbbbbbbbbbbbbbbbbbbbbbbbbbbbbbbbbbbbbbbbbbbgghhhhhhhhhhhggbbbbbbbbbbbbbbbbbbbbbbbbbbbbbbbbbbbbbbbbbbbbbbbbbbbbbbbbbbbbaaa
aaabbbbbbbbbbbbbbbbbbbbbbbbbbbbbbbbbbbbbbbbbbbbgghhhhhlhhhhhggbbbbbbbbbbbbbbbbbbbbbbbbbbbbbbbbbbbbbbbbbbbbbbbbbbbbbbbbbbbbaaa
aaabbbbbbbbbbbbbbbbbbbbbbbbbbbbbbbbbbbbbbbbbbbbgghhhhhhhhhhhggbbbbbbbbbbbbbbbbbbbbbbbbbbbbbbbbbbbbbbbbbbbbbbbbbbbbbbbbbbbbaaa
aaabbbbbbbbbbbbbbbbbbbbbbbbbbbbbbbbbbbbbbbbbbbbgghhhhhhhhhhhggbbbbbbbbbbbbbbbbbbbbbbbbbbbbbbbbbbbbbbbbbbbbbbbbbbbbbbbbbbbbaaa
aaabbbbbbbbbbbbbbbbbbbbbbbbbbbbbbbbbbbbbbbbbbbbgghhhhhhhhhhhggbbbbbbbbbbbbbbbbbbbbbbbbbbbbbbbbbbbbbbbbbbbbbbbbbbbbbbbbbbbbaaa
aaabbbbbbbbbbbbbbbbbbbbbbbbbbbbbbbbbbbbbbbbbbbbgghhhhhhhhhhhggbbbbbbbbbbbbbbbbbbbbbbbbbbbbbbbbbbbbbbbbbbbbbbbbbbbbbbbbbbbbaaa
aaabbbbbbbbbbbbbbbbbbbbbbbbbbbbbbbbbbbbbbbbbbbbgghhhhhhhhhhhggbbbbbbbbbbbbbbbbbbbbbbbbbbbbbbbbbbbbbbbbbbbbbbbbbbbbbbbbbbbbaaa
aaabbbbbbbbbbbbbbbbbbbbbbbbbbbbbbbbbbbbbbbbbbbbgghhhhhhhhhhhggbbbbbbbbbbbbbbbbbbbbbbbbbbbbbbbbbbbbbbbbbbbbbbbbbbbbbbbbbbbbaaa
aaabbbbbbbbbbbbbbbbbbbbbbbbbbbbbbbbbbbbbbbbbbbbggggggghgggggggbbbbbbbbbbbbbbbbbbbbbbbbbbbbbbbbbbbbbbbbbbbbbbbbbbbbbbbbbbbbaaa
aaabbbbbbbbbbbbbbbbbbbbbbbbbbbbbbbbbbbbbbbbbbbbggggghhhhhgggggbbbbbbbbbbbbbbbbbbbbbbbbbbbbbbbbbbbbbbbbbbbbbbbbbbbbbbbbbbbbaaa
aaabbbbbbbbbbbbbbbbbbbbbbbbbbbbbbbbbbbbbbbbbbbbbbbghhhhhhhgbbbbbbbbbbbbbbbbbbbbbbbbbbbbbbbbbbbbbbbbbbbbbbbbbbbbbbbbbbbbbbbaaa
aaabbbbbbbbbbbbbbbbbbbbbbbbbbbbbbbbbbbbbbbbbbbbbbbghggggghgbbbbbbbbbbbbbbbbbbbbbbbbbbbbbbbbbbbbbbbbbbbbbbbbbbbbbbbbbbbbbbbaaa
aaabbbbbbbbbbbbbbbbbbbbbbbbbbbbbbbbbbbbbbbbbbbbbbbghhhhhhhgbbbbbbbbbbbbbbbbbbbbbbbbbbbbbbbbbbbbbbbbbbbbbbbbbbbbbbbbbbbbbbbaaa
aaabbbbbbbbbbbbbbbbbbbbbbbbbbbbbbbbbbbbbbbbbbbbbbbghhhihhhgbbbbbbbbbbbbbbbbbbbbbbbbbbbbbbbbbbbbbbbbbbbbbbbbbbbbbbbbbbbbbbbaaa
aaabbbbbbbbbbbbbbbbbbbbbbbbbbbbbbbbbbbbbbbbbbbbbbbghhjhjhhgbbbbbbbbbbbbbbbbbbbbbbbbbbbbbbbbbbbbbbbbbbbbbbbbbbbbbbbbbbbbbbbaaa
aaabbbbbbbbbbbbbbbbbbbbbbbbbbbbbbbbbbbbbbbbbbbbbbbghhhhhhhgbbbbbbbbbbbbbbbbggggggggggbbbbbbbbbbbbbbbbbbbbbbbbbbbbbbbbbbbbbaaa
aaabbbbbbbbbbbbbbbbbbbbbbbbbbbbbbbbbbbbbbbbbbbbbbbgggghggggbbbbbbbbbbbbbbbbghhhkuhhhgbbbbbbbbbbbbbbbbbbbbbbbbbbbbbbbbbbbbbaaa
aaabbbbbbbbbbbbbbbbbbbbbbbbbbbbbbggggggggbbbbbbbbbghhhhhhhgbbbbbbbbbbbbbbbbghhhhhhhhgbbbbbbbbbbbbbbbbbbbbbbbbbbbbbbbbbbbbbaaa
aaabbbbbbbbbbbbbbbbbbbbbbbbbbbbbbghhhhhhgbbbbbbbbgghhhhhhhggbbbbbbbbbbbbbbbghhhmhhhhgbbbbbbbbbbbbbbbbbbbbbbbbbbbbbbbbbbbbbaaa
aaabbbbbbbbbbbbbbbbbbbbbbbbbbbbbbghhhhhhgbbbbbbbbghhhhhhjhhgbbbbbbbbbbbbbbbghhjhhhhhgbbbbbbbbbbbbbbbbbbbbbbbbbbbbbbbbbbbbbaaa
aaabbbbbbbbbbbbbbbbbbbbbbbbbbbbbbghhgghggbbbbbbbbghhhhhhhhhgbbbbbbbbbbbbbbbghhhhmhhhgbbbbbbbbbbbbbbbbbbbbbbbbbbbbbbbbbbbbbaaa
aaabbbbbbbbbbbbbbbbbbbbbbbbbbbbbbghhghhhgggggggggghhhhhhihhgggggggggggggggggghhhhhhhgbbbbbbbbbbbbbbbbbbbbbbbbbbbbbbbbbbbbbaaa
aaabbbbbbbbbbbbbbbbbbbbbbbbbbbbbbghhghhjghhhhhhhhhhihjhjhhhhhhhhhhhhgggggggghhhhhhhhgbbbbbbbbbbbbbbbbbbbbbbbbbbbbbbbbbbbbbaaa
aaabbbbbbbbbbbbbbbbbbbbbbbbbbbbbbghhghhhghhhhhhhhhhhhhhhhhhhhhhhhhhhggggggghhhgggggggbbbbbbbbbbbbbbbbbbbbbbbbbbbbbbbbbbbbbaaa
aaabbbbbbbbbbbbbbbbbbbbbbbbbbbbbbgjhghjhghhggggggggggggggggggggggghhhhhhhhhhgggggbbbbbbbbbbbbbbbbbbbbbbbbbbbbbbbbbbbbbbbbbaaa
aaabbbbbbbbbbbbbbbbbbbbbbbbbbbbbbghjghhhghmghhhhhhhhhhhhhhhhhhhhhgmhgggggggggbbbbbbbbbbbbbbbbbbbbbbbbbbbbbbbbbbbbbbbbbbbbbaaa
aaabbbbbbbbbbbbbbbbbbbbbbbbbbbbbbghhgggggjhghhhhhhhhhhhhhhhhhhhhhghjgbbbbbbbbbbbbbbbbbbbbbbbbbbbbbbbbbbbbbbbbbbbbbbbbbbbbbaaa
aaabbbbbbbbbbbbbbbbbbbbbbbbbbbbbbghhhhhhhhhghhhhhhhhhhhhhhhhhhhhhghhgbbbbbbbbbbbbbbbbbbbbbbbbbbbbbbbbbbbbbbbbbbbbbbbbbbbbbaaa
aaabbbbbbbbbbbbbbbbbbbbbbbbbbbbbbghhggggghhhhhhhhhhhhhhhhhhhhhhhhhhhgbbbbbbbbbbbbbbbbbbbbbbbbbbbbbbbbbbbbbbbbbbbbbbbbbbbbbaaa
aaabbbbbbbbbbbbbbbbbbbbbbbbbbbbbbghhghhhghhghhhhhhhhmhhhhhhhhhhhhghhgbbbbbbbbbbbbbbbbbbbbbbbbbbbbbbbbbbbbbbbbbbbbbbbbbbbbbaaa
aaabbbbbbbbbbbbbbbbbbbbbbbbbbbbbbghhghhhghhghhhhhhhhhnmhhhhhhhhhhghhgbbbbbbbbbbbbbbbbbbbbbbbbbbbbbbbbbbbbbbbbbbbbbbbbbbbbbaaa
aaabbbbbbbbbbbbbbbbbbbbbbbbbbbbbbghhghhhghhghhhhhhhhhhhhhhhhhhhhhghhgbbbbbbbbbbbbbbbbbbbbbbbbbbbbbbbbbbbbbbbbbbbbbbbbbbbbbaaa
aaabbbbbbbbbbbbbbbbbbbbbbbbbbbbbbghjghhhgggghhhhhhhhhhhhhhhhhhhhhggggbbbbbbbbbbbbbbbbbbbbbbbbbbbbbbbbbbbbbbbbbbbbbbbbbbbbbaaa
aaabbbbbbbbbbbbbbbbbbbbbbbbbbbbbbgjhghhhhhgghhhhhhhhhhhhhhhhhhhhhgbbbbbbbbbbbbbbbbbbbbbbbbbbbbbbbbbbbbbbbbbbbbbbbbbbbbbbbbaaa
aaabbbbbbbbbbbbbbbbbbbbbbbbbbbbbbghhghhhhhggggggggggghhgggggggggggbbbbbbbbbbbbbbbbbbbbbbbbbbbbbbbbbbbbbbbbbbbbbbbbbbbbbbbbaaa
aaabbbbbbbbbbbbbbbbbbbbbbbbbbbbbbghhghhhhhggbbbbbbbbghhgbbbbbbbbbbbbbbbbbbbbbbbbbbbbbbbbbbbbbbbbbbbbbbbbbbbbbbbbbbbbbbbbbbaaa
aaabbbbbbbbbbbbbbbbbbbbbbbbbbbbbbghhghggggggbbbbbbbbghhgbbbbbbbbbbbbbbbbbbbbbbbbbbbbbbbbbbbbbbbbbbbbbbbbbbbbbbbbbbbbbbbbbbaaa
aaabbbbbbbbbbbbbbbbbbbbbbbbbbbbbbghhghghkhhgbbbbbbbbghhgbbbbbbbbbbbbbbbbbbbbbbbbbbbbbbbbbbbbbbbbbbbbbbbbbbbbbbbbbbbbbbbbbbaaa
aaabbbbbbbbbbbbbbbbbbbbbbbbbbbbbbghhggghhjhgbbbbbbbbghhgbbbbbbbbbbbbbbbbbbbbbbbbbbbbbbbbbbbbbbbbbbbbbbbbbbbbbbbbbbbbbbbbbbaaa
aaabbbbbbbbbbbbbbbbbbbbbbbbbbbbbbghhhhhhhhhgbbbbbbbbghhgbbbbbbbbbbbbbbbbbbbbbbbbbbgggggggggggggggggggggggggggbbbbbbbbbbbbbaaa
aaabbbbbbbbbbbbbbbbbbbbbbbbbbbbbbgggggghjhvgbbbbbbbbghhgbbbbbbbbbbbbbbbbbbbbbbbbbbgghhjhhhhhhmhhhhhhhhhhhhhhgbbbbbbbbbbbbbaaa
aaabbbbbbbbbbbbbbbbbbbbbbbbbbbbbbbbbghhhhhhgbbbbbbbbghhgbbbbbbbbbbbbbbbbbbbbbbbbbbgghhhhhjhhhhhhhhhhhhhhhhjhgbbbbbbbbbbbbbaaa
aaabbbbbbbbbbbbbbbbbbbbbbbbbbbbbbbbbghhhhhhgbbbbbbbbghhgbbbbbbbbbbbbbbbbbbbbbbbbbbgghgggggggggggggggggggghhhgbbbbbbbbbbbbbaaa
aaabbbbbbbbbbbbbbbbbbbbbbbbbbbbbbbbbggggggggbbbbbbbbgjhgbbbbbbbbbbbbbbbbbbbbbbbbbbgghgggggggggggggggggggghhhgbbbbbbbbbbbbbaaa
aaabbbbbbbbbbbbbbbbbbbbbbbbbbbbbbbbbbbbbggggggggggggghjggggggggggggggggbbbbbbbbbbbgghgghhhhhhhhhhhhhhggghhhhgbbbbbbbbbbbbbaaa
aaabbbbbbbbbbbbbbbbbbbbbbbbbbbbbbbbbbbbbggggggggggggghhggggggggggggggggbbbbbbbbbbbgghgghhhhhhhhhhhjhhggghhhhgbbbbbbbbbbbbbaaa
aaabbbbbbbbbbbbbbbbbbbbbbbbbbbbbbbbbbbbbgghhhhhhhhhhhhhhhhhhhhhhhhhhhggbbbbbwbbbbbgghgghhhhhjhhhhhhhhggghhhjgbbbbbbbbbbbbbaaa
aaabbbbbbbbbbbbbbbbbbbbbbbbbbbbbbbbbbbbbgghhhhhhhhhhhjhhhhhhhhhhhhhhhggbbbbbbbbbbbgghgghhhhhhhhhhhhhhggghhhhgbbbbbbbbbbbbbaaa
aaabbbbbbbbbbbbbbbbbbbbbbbbbbbbbbbbbbbbbgghhgghhhhhhhhhjhhhhhhhhhgghhggbbbbbbbbbbbgghgghhhhhhhhhhhhhhggghhhhgbbbbbbbbbbbbbaaa
aaabbbbbbbbbbbbbbbbbbbbbbbbbbbbbbbbbbbbbgghhgghhhjhhhhhhhhjhhhhhhgghhggggggggggggggghggggghhhhhhhhhhhggghhhhgbbbbbbbbbbbbbaaa
aaabbbbbbbbbbbbbbbbbbbbbbbbbbbbbbbbbbbbbgghhhkhhhhhjhhhhhhhhhhhhhhhhhgghhhhkkxxhhhhhhhhhhghhhhhhhhhhhggghhhhgbbbbbbbbbbbbbaaa
aaabbbbbbbbbbbbbbbbbbbbbbbbbbbbbbbbbbbbbgghhhhhhhhhhhhhhhjhhhjhhhhhhhgghhhhhhhhhhhhhhhhhhghhjhhhjhhhhggghjhhgbbbbbbbbbbbbbaaa
aaabbbbbbbbbbbbbbbbbbbbbbbbbbbbbbbbbbbbbgghhgghhhhjhhhhhjhhhhhhhhgghhgghhhhhhhhhhhhhhhhhhghhhhhhhmhhhggghhhhgbbbbbbbbbbbbbaaa
aaabbbbbbbbbbbbbbbbbbbbbbbbbbbbbbbbbbbbbgghhgghhhhhhjhhhhhhhhhhjhgghhgghhhhhhhhhhhhhhhhhhghhhhhjhhhhhggghhhmgbbbbbbbbbbbbbaaa
aaabbbbbbbbbbbbbbbbbbbbbbbbbbbbbbbbbbbbbgghhhhhhhhhhhhhhhhhhhhhhhhhhhgghhhhhhhhhhhhhhhhhhghhhhhhhhhhhggghhhhgbbbbbbbbbbbbbaaa
aaabbbbbbbbbbbbbbbbbbbbbbbbbbbbbbbbbbbbbgghhhhhhhhhhhhhhhjhhhhhhhhhhhgghhhhhhhhohhhhhhhhhghhhhhhhhhhhggghhhhgbbbbbbbbbbbbbaaa
aaabbbbbbbbbbbbbbbbbbbbbbbbbbbbbbbbbbbbbgghhgghjhhhhjhhjhhhjhhhhhgghhgghhhhhhhhhhhhhhhhhhghhhjhhhhhhhggghhhhgbbbbbbbbbbbbbaaa
aaabbbbbbbbbbbbbbbbbbbbbbbbbbbbbbbbbbbbbgghhgghhhhhhhhhhhhhhhhhhhgghhgghhhhhhhhphhhhhhhhhghhhhhhhhhhhggghhhjgbbbbbbbbbbbbbaaa
aaabbbbbbbbbbbbbbbbbbbbbbbbbbbbbbbbbbbbbgghhhhhhhhhhjhhhhhhhhhhhhhhhhgghhhhhhhhhhhhhhhhhhghhhhhhhhhhhggghhhhgbbbbbbbbbbbbbaaa
aaabbbbbbbbbbbbbbbbbbbbbbbbbbbbbbbbbbbbbgghhhhhhhhhhhhhhhhhhjhhhhhhhhgghhhhhhhhhhhhhhhhhhghhhhhhhjhhhggghhhhgbbbbbbbbbbbbbaaa
aaabbbbbbbbbbbbbbbbbbbbbbbbbbbbbbbbbbbbbgghhgghhhhhhhhhjhjhhhhhhhgghhgghhhhhhhhhhhhhhhhhhghhhmhhhhhhhggghjhhgbbbbbbbbbbbbbaaa
aaabbbbbbbbbbbbbbbbbbbbbbbbbbbbbbbbbbbbbgghhgghhjhhhhhhhhhhhhhjhhgghhgghhhhhhhhhhhhhhhhhhghhhhhhhhhhhggghhhhgbbbbbbbbbbbbbaaa
aaabbbbbbbbbbbbbbbbbbbbggggggggggggggggggghhhhhhhhhjhhhjhhhhhhhhhhhhhgghhhhhhhhhhhhhhhhhhghhhhhhhhhhhggghhhhgbbbbbbbbbbbbbaaa
aaabbbbbbbbbbbbbbbbbbbbghhhhhhhhhhhhhhhggghhhhhhhhhhhhhhhhhhhjhhhhhhhgghhhhhhhhhhhhhhhhhhghjhhhgghhhhggghhhhgbbbbbbbbbbbbbaaa
aaabbbbbbbbbbbbbbbbbbbbghhjhhhhhhhhhhhhggghhgghhhhhhjhhhhhhhhhhhhgghhgghhhhhhhhhhhhhhhhhhghhhhhgghhhhggghhjhgbbbbbbbbbbbbbaaa
aaabbbbbbbbbbbbbbbbbbbbghhhhhhhhhhhhhhhggghhgghhhhhhhhhhhhhhhhhhhgghhgghhhhhhhhhhhhhhhhhhghhhhhgghhhhhgghhmhgbbbbbbbbbbbbbaaa
aaabbbbbbbbbbbbbbbbbbbbghhjhhhhggghhjhhgggggggggggggghhgggggggggggggggghhhhggggggggggggggghhhhhgghhhhhgghhhhgbbbbbbbbbbbbbaaa
aaabbbbbbbbbbbbbbbbbbbbghhhhhhhggghhhjhgggggggggggggghhgggggggggggggggghhhhghgggbbbbbbgghhhhhhhgghhhhhgghhhhgbbbbbbbbbbbbbaaa
aaabbbbbbbbbbbbbbbbbbbbghggggggggghhhhhhhhhhhhhhhhhhhhhhhhhhhhhhhhhhhhhhhhhhhgggbbbbbbgghhhhhhhgghhhhhgghhhhgbbbbbbbbbbbbbaaa
aaabbbbbbbbbbbbbbbbbbbbghggggggggghhhhhhhhhhhhhhhhhhhhhhhhhhhhhhhhhhhhhhhhhhhgggbbbbbbgghhhhhhhgghhhhhgghhhhgbbbbbbbbbbbbbaaa
aaabbbbbbbbbbbbbbbbbbbbghhhhgghgggggggggggggggggggggggggggggggggggggggggggggggggbbbbbbgghhhhhhhgghhhhhgghhhhgbbbbbbbbbbbbbaaa
aaabbbbbbbbbbbbbbbbbbbbghhhhgghggggggggggggggggggggggggggggggggggggggggggggggbbbbbbbbbgghhhhhhhgghhhhhgghhhhgbbbbbbbbbbbbbaaa
aaabbbbbbbbbbbbbbbbbbbbghjhhgghhhhhhhhhhhhhhhhhhhhhhghhhhhhhhhhhhhgggggggggggbbbbbbbbbgghhhhhhhgghhhhhgghhhhgbbbbbbbbbbbbbaaa
aaabbbbbbbbbbbbbbbbbbbbghhhhgghhhhhhhhjhhhhhhhhhhhhhghghhhhhhhhhqhggbbbbbbbbbbbbbbbbbbggggggghhgghhhhhhhhhhhgbbbbbbbbbbbbbaaa
aaabbbbbbbbbbbbbbbbbbbbghhjhgghhhhhhhhhhhhhhhhhhhhhhhhghhhhhhhhhhhggbbbbbbbbbbbbbbbbbbggkhhhhhhgghhhhhhhhhhhgbbbbbbbbbbbbbaaa
aaabbbbbbbbbbbbbbbbbbbbghhhhgghhhhjhhhhhhhjhhhghhgggggggggggggggggggggggggggggggggggggggghhgggggggggggggghhggbbbbbbbbbbbbbaaa
aaabbbbbbbbbbbbbbbbbbbbghhhhhhhhhhhhhhhhhhhhhhghhhhghhhhhhghhhhhhhhhhhhhhhhhhhhhhhhhhhhhhhhhhhhhhhhhhhhhghhhgbbbbbbbbbbbbbaaa
aaabbbbbbbbbbbbbbbbbbbbgggggggggggggggggggggggghhhhghjhhhhghghhhhjhhhhhhhjhhhhhhhhhhhhhhgggghhhhhhhhhhhhghhhgbbbbbbbbbbbbbaaa
aaabbbbbbbbbbbbbbbbbbbbbbbbbbbbbbbbbbbbbbbbbbbghhhhghhhhjhghghhhhhhhhhhhhhhhhhjhhhhhhjhhhhhhhhhhhhhhjhhhghhhgbbbbbbbbbbbbbaaa
aaabbbbbbbbbbbbbbbbbbbbbbbbbbbbbbbbbbbbbbbbbbbghhhhhhhhhhhhhghhhhjhhhhjhhhhhhhhhhjhhhhhhhhhhhhjhhhhhhhhhghhhgbbbbbbbbbbbbbaaa
aaabbbbbbbbbbbbbbbbbbbbbbbbbbbbbbbbbbbbbbbbbbbgggggggghhgggggghhhhhhhhhhhhhhhhhhhhhhhhhhhhhhhhhhhhhhhhhhhhhhgbbbbbbbbbbbbbaaa
aaabbbbbbbbbbbbbbbbbbbbbbbbbbbbbbbbbbbbbbbbbbbbbgggggghhggggggggggggggggggggggggggggggggggggggggggggggggggggggbbbbbbbbbbbbaaa
aaabbbbbbbbbbbbbbbbbbbbbbbbbbbbbbbbbbbbbbbbbbbbbgghhhhhhhhhhggbbbbbbbbbbbbbbbbbbbbbbbbbbbbbbbbbbbbbbbbbbbbbbbbbbbbbbbbbbbbaaa
aaabbbbbbbbbbbbbbbbbbbbbbbbbbbbbbbbbbbbbbbbbbbbbgghhhhhhhhhhggbbbbbbbbbbbbbbbbbbbbbbbbbbbbbbbbbbbbbbbbbbbbbbbbbbbbbbbbbbbbaaa
aaabbbbbbbbbbbbbbbbbbbbbbbbbbbbbbbbbbbbbbbbbbbbbgghhhhhhhhhhggbbbbbbbbbbbbbbbbbbbbbbbbbbbbbbbbbbbbbbbbbbbbbbbbbbbbbbbbbbbbaaa
aaabbbbbbbbbbbbbbbbbbbbbbbbbbbbbbbbbbbbbbbbbbbbbgghhhhhhhhhhggbbbbbbbbbbbbbbbbbbbbbbbbbbbbbbbbbbbbbbbbbbbbbbbbbbbbbbbbbbbbaaa
aaabbbbbbbbbbbbbbbbbbbbbbbbbbbbbbbbbbbbbbbbbbbbbgghhhhhrhhhhggbbbbbbbbbbbbbbbbbbbbbbbbbbbbbbbbbbbbbbbbbbbbbbbbbbbbbbbbbbbbaaa
aaabbbbbbbbbbbbbbbbbbbbbbbbbbbbbbbbbbbbbbbbbbbbbgghhhhhhhhhhggbbbbbbbbbbbbbbbbbbbbbbbbbbbbbbbbbbbbbbbbbbbbbbbbbbbbbbbbbbbbaaa
aaabbbbbbbbbbbbbbbbbbbbbbbbbbbbbbbbbbbbbbbbbbbbbgghgggggggghggbbbbbbbbbbbbbbbbbbbbbbbbbbbbbbbbbbbbbbbbbbbbbbbbbbbbbbbbbbbbaaa
aaabbbbbbbbbbbbbbbbbbbbbbbbbbbbbbbbbbbbbbbbbbbbbgghhhhhhhhhhggbbbbbbbbbbbbbbbbbbbbbbbbbbbbbbbbbbbbbbbbbbbbbbbbbbbbbbbbbbbbaaa
aaabbbbbbbbbbbbbbbbbbbbbbbbbbbbbbbbbbbbbbgggggggggggghhhggggggggggggggbbbbbbbbbbbbbbbbbbbbbbbbbbbbbbbbbbbbbbbbbbbbbbbbbbbbaaa
aaabbbbbbbbbbbbbbbbbbbbbbbbbbbbbbbbbbbbbbgggggggggggghhhggggggggggggggbbbbbbbbbbbbbbbbbbbbbbbbbbbbbbbbbbbbbbbbbbbbbbbbbbbbaaa
aaabbbbbbbbbbbbbbbbbbbbbbbbbbbbbbbbbbbbbbggghykzhhggghhhggghhhAkBhhgggbbbbbbbbbbbbbbbbbbbbbbbbbbbbbbbbbbbbbbbbbbbbbbbbbbbbaaa
aaabbbbbbbbbbbbbbbbbbbbbbbbbbbbbbbbbbbbbbgghhhhhhhhgghhhgghhhhhhhhhhggbbbbbbbbbbbbbbbbbbbbbbbbbbbbbbbbbbbbbbbbbbbbbbbbbbbbaaa
aaabbbbbbbbbbbbbbbbbbbbbbbbbbbbbbbbbbbbbbgghhhhhhhhhghhhghhhhhhhhhhhggbbbbbbbbbbbbbbbbbbbbbbbbbbbbbbbbbbbbbbbbbbbbbbbbbbbbaaa
aaabbbbbbbbbbbbbbbbbbbbbbbbbbbbbbbbbbbbbbgghhhhhhhhhhhhhhhhhhhhhhhhhggbbbbbbbbbbbbbbbbbbbbbbbbbbbbbbbbbbbbbbbbbbbbbbbbbbbbaaa
aaabbbbbbbbbbbbbbbbbbbbbbbbbbbbbbbbbbbbbbgghhhhhhhhhhhhhhhhhhhhhhhhhggbbbbbbbbbbbbbbbbbbbbbbbbbbbbbbbbbbbbbbbbbbbbbbbbbbbbaaa
aaabbbbbbbbbbbbbbbbbbbbbbbbbbbbbbbbbbbbbbgghhhhhhhhhhhhhhhhhhhhhhhhhggbbbbbbbbbbbbbbbbbbbbbbbbbbbbbbbbbbbbbbbbbbbbbbbbbbbbaaa
aaabbbbbbbbbbbbbbbbbbbbbbbbbbbbbbbbbbbbbbgghhhhhhhhhhhhhhhhhhhhhhhhhggbbbbbbbbbbbbbbbbbbbbbbbbbbbbbbbbbbbbbbbbbbbbbbbbbbbbaaa
aaabbbbbbbbbbbbbbbbbbbbbbbbbbbbbbbbbbbbbbgghhhhhhhhhhhhhhhhhhhhhhhhhggbbbbbbbbbbbbbbbbbbbbbbbbbbbbbbbbbbbbbbbbbbbbbbbbbbbbaaa
aaabbbbbbbbbbbbbbbbbbbbbbbbbbbbbbbbbbbbbbgghhhhhhhhhhhhhhhhhhhhhhhhhggbbbbbbbbbbbbbbbbbbbbbbbbbbbbbbbbbbbbbbbbbbbbbbbbbbbbaaa
aaabbbbbbbbbbbbbbbbbbbbbbbbbbbbbbbbbbbbbbgghhhhhhhhhhhshhhhhhhhhhhhhggbbbbbbbbbbbbbbbbbbbbbbbbbbbbbbbbbbbbbbbbbbbbbbbbbbbbaaa
aaabbbbbbbbbbbbbbbbbbbbbbbbbbbbbbbbbbbbbbgghhhhhhhhhhhhhhhhhhhhhhhhhggbbbbbbbbbbbbbbbbbbbbbbbbbbbbbbbbbbbbbbbbbbbbbbbbbbbbaaa
aaabbbbbbbbbbbbbbbbbbbbbbbbbbbbbbbbbbbbbbgghhhhhhhhhhhhhhhhhhhhhhhhhggbbbbbbbbbbbbbbbbbbbbbbbbbbbbbbbbbbbbbbbbbbbbbbbbbbbbaaa
aaabbbbbbbbbbbbbbbbbbbbbbbbbbbbbbbbbbbbbbggghhhhhhhhhhthhhhhhhhhhhhgggbbbbbbbbbbbbbbbbbbbbbbbbbbbbbbbbbbbbbbbbbbbbbbbbbbbbaaa
aaabbbbbbbbbbbbbbbbbbbbbbbbbbbbbbbbbbbbbbggggggggggghhhhhgggggggggggggbbbbbbbbbbbbbbbbbbbbbbbbbbbbbbbbbbbbbbbbbbbbbbbbbbbbaaa
aaabbbbbbbbbbbbbbbbbbbbbbbbbbbbbbbbbbbbbbgggggggggggghhhggggggggggggggbbbbbbbbbbbbbbbbbbbbbbbbbbbbbbbbbbbbbbbbbbbbbbbbbbbbaaa
aaabbbbbbbbbbbbbbbbbbbbbbbbbbbbbbbbbbbbbbbbbbbbbbbbgghhhggbbbbbbbbbbbbbbbbbbbbbbbbbbbbbbbbbbbbbbbbbbbbbbbbbbbbbbbbbbbbbbbbaaa
aaabbbbbbbbbbbbbbbbbbbbbbbbbbbbbbbbbbbbbbbbbbbbbbbbgghhhggbbbbbbbbbbbbbbbbbbbbbbbbbbbbbbbbbbbbbbbbbbbbbbbbbbbbbbbbbbbbbbbbaaa
aaabbbbbbbbbbbbbbbbbbbbbbbbbbbbbbbbbbbbbbbbbbbbbbbbgghhhggbbbbbbbbbbbbbbbbbbbbbbbbbbbbbbbbbbbbbbbbbbbbbbbbbbbbbbbbbbbbbbbbaaa
aaabbbbbbbbbbbbbbbbbbbbbbbbbbbbbbbbbbbbbbbbbbbbbbbbaaeeeaabbbbbbbbbbbbbbbbbbbbbbbbbbbbbbbbbbbbbbbbbbbbbbbbbbbbbbbbbbbbbbbbaaa
aaabbbbbbbbbbbbbbbbbbbbbbbbbbbbbbbbbbbbbbbbbbbbbbbbaaeeeaabbbbbbbbbbbbbbbbbbbbbbbbbbbbbbbbbbbbbbbbbbbbbbbbbbbbbbbbbbbbbbbbaaa
aaabbbbbbbbbbbbbbbbbbbbbbbbbbbbbbbbbbbbbbbbbbbbbbbbaaefeaabbbbbbbbbbbbbbbbbbbbbbbbbbbbbbbbbbbbbbbbbbbbbbbbbbbbbbbbbbbbbbbbaaa
aaaaaaaaaaaaaaaaaaaaaaaaaaaaaaaaaaaaaaaaaaaaaaaaaaaaaaaaaaaaaaaaaaaaaaaaaaaaaaaaaaaaaaaaaaaaaaaaaaaaaaaaaaaaaaaaaaaaaaaaaaaaa
aaaaaaaaaaaaaaaaaaaaaaaaaaaaaaaaaaaaaaaaaaaaaaaaaaaaaaaaaaaaaaaaaaaaaaaaaaaaaaaaaaaaaaaaaaaaaaaaaaaaaaaaaaaaaaaaaaaaaaaaaaaaa
aaaaaaaaaaaaaaaaaaaaaaaaaaaaaaaaaaaaaaaaaaaaaaaaaaaaaaaaaaaaaaaaaaaaaaaaaaaaaaaaaaaaaaaaaaaaaaaaaaaaaaaaaaaaaaaaaaaaaaaaaaaaa
"}
