"a" = (/turf/UnbreakableTurfs/Void_Wall,/area/Outside)
"b" = (/turf/Other/Blank,/area/Outside)
"c" = (/turf/Stairs1,/area/Outside)
"d" = (/obj/dungeon_exit,/turf/Stairs1,/area/Outside)
"e" = (/turf/Stairs4,/area/Outside)
"f" = (/obj/dungeon_exit{isClearingExit = 1},/turf/Stairs4,/area/Outside)
"g" = (/turf/TileWhite{density = 1; destroyable = 0; opacity = 1},/area/Outside)
"h" = (/turf/Ground/GroundIce,/area/Outside)
"i" = (/turf/Grass/Grass10,/area/Outside)
"j" = (/turf/Ground/Ground7,/area/Outside)
"k" = (/turf/Ground/GroundIce2,/area/Outside)
"l" = (/obj/buildables/Fire,/turf/Grass/Grass10,/area/Outside)
"m" = (/mob/npc/Enemy/Black_Saibaman,/turf/Ground/GroundIce2,/area/Outside)
"n" = (/mob/npc/Enemy/Ice_Flame,/turf/Ground/GroundIce2,/area/Outside)
"o" = (/obj/items/First_Aid_Kit,/turf/Ground/GroundIce2,/area/Outside)
"p" = (/mob/npc/Enemy/Ice_Dragon,/turf/Ground/GroundIce2,/area/Outside)
"q" = (/obj/items/Viruses/Virus_Charlie,/turf/Ground/GroundIce2,/area/Outside)
"r" = (/mob/npc/Enemy/Bandit,/turf/Ground/GroundIce2,/area/Outside)
"s" = (/mob/npc/Enemy/Mutated_Saibaman,/turf/Ground/GroundIce2,/area/Outside)
"t" = (/obj/items/Punching_Bag,/turf/Ground/GroundIce2,/area/Outside)
"u" = (/obj/items/Stungun,/turf/Ground/GroundIce2,/area/Outside)
"v" = (/obj/items/Research_Book{IntPower = 50},/turf/Ground/GroundIce2,/area/Outside)
"w" = (/turf/Ground/GroundIce2,/turf/itemspawners/Chestspawner,/area/Outside)
"x" = (/obj/items/Key{password = list("BDOOR432")},/turf/Ground/GroundIce2,/area/Outside)
"y" = (/mob/npc/Enemy/Bosses/Golem,/turf/Ground/GroundIce2,/area/Outside)
"z" = (/obj/items/food/Yemma_Fruit,/turf/Ground/GroundIce2,/area/Outside)
"A" = (/obj/items/Potara_Earring{name = "Lost Potara Earring (Left)"},/turf/Ground/GroundIce2,/area/Outside)
"B" = (/obj/items/Potara_Earring{icon = 'Icons/Clothes/potararight.dmi'; name = "Lost Potara Earring (Right)"},/turf/Ground/GroundIce2,/area/Outside)
"C" = (/mob/npc/Enemy/Bosses/Lost_Soldier,/turf/Ground/GroundIce2,/area/Outside)
"D" = (/turf/Ground/GroundIce2,/turf/Door/Door4{password = "BDOOR432"},/area/Outside)
"E" = (/obj/items/Clawed_Talisman,/turf/Ground/GroundIce2,/area/Outside)
"F" = (/obj/items/Key{password = list("BDOOR435")},/turf/Ground/GroundIce2,/area/Outside)
"G" = (/mob/npc/Enemy/Bosses/Dire_Demon,/turf/Ground/GroundIce2,/area/Outside)
"H" = (/turf/Ground/GroundIce2,/turf/Door/Door1{password = "BDOOR435"},/area/Outside)
"I" = (/obj/items/food/Apple_Of_Eden,/turf/Ground/GroundIce2,/area/Outside)

(1,1,1) = {"
aaaaaaaaaaaaaaaaaaaaaaaaaaaaaaaaaaaaaaaaaaaaaaaaaaaaaaaaaaaaaaaaaaaaaaaaaaaaaaaaaaaaaaaaaaaaaaaaaaaaaaaaaaaaaaaaaaaaaaaaaaaaa
aaaaaaaaaaaaaaaaaaaaaaaaaaaaaaaaaaaaaaaaaaaaaaaaaaaaaaaaaaaaaaaaaaaaaaaaaaaaaaaaaaaaaaaaaaaaaaaaaaaaaaaaaaaaaaaaaaaaaaaaaaaaa
aaaaaaaaaaaaaaaaaaaaaaaaaaaaaaaaaaaaaaaaaaaaaaaaaaaaaaaaaaaaaaaaaaaaaaaaaaaaaaaaaaaaaaaaaaaaaaaaaaaaaaaaaaaaaaaaaaaaaaaaaaaaa
aaabbbbbbbbbbbbbbbbbbbbbbbbbbbbbbbbbbggggggghhhhhiihhccchhiihhhhjjjjggbbbbbbbbbbbbbbbbbbbbbbbbbbbbbbbbbbbbbbbbbbbbbbbbbbbbaaa
aaabbbbbbbbbbbbbbbbbbbbbbbbbbbbbbbbbbggjjjjjjjhhiiihhcdchhiiihhhjjjjggbbbbbbbbbbbbbbbbbbbbbbbbbbbbbbbbbbbbbbbbbbbbbbbbbbbbaaa
aaabbbbbbbbbbbbbbbbbbbbbbbbbbbbbbbbbbggjjjjjjjhhiiihhccchhiiihhhjjjjgggggggggggggggggggbbbbbbbbbbbbbbbbbbbbbbbbbbbbbbbbbbbaaa
aaabbbbbbbbbbbbbbbbbbbbbbbbbbbbbbbbbbggjjjjjjjhhiiihhccchhiiihhhjjjjgggggggggggggggggggbbbbbbbbbbbbbbbbbbbbbbbbbbbbbbbbbbbaaa
aaabbbbbbbbbbbbbbbbbbbbbbbbbbbbbbbbbbggjjjjjjjhhiiihhhhhhhiiihhhhjjjkkkkkkkkkkkkkkkkkggbbbbbbbbbbbbbbbbbbbbbbbbbbbbbbbbbbbaaa
aaabbbbbbbbbbbbbbbbbbbbbbbbbbbbbbbbbbggjjjjjjjhhiiihhhhhhhiiihhhhjjjkkkkkkkkkkkkkkkkkggbbbbbbbbbbbbbbbbbbbbbbbbbbbbbbbbbbbaaa
aaabbbbbbbbbbbbbbbbbbbbbbbbbbbbbbbbbbggjjjjjhhhhhiiiiiiiiiiihhhhhjjjggggggggggkkkkkkkggbbbbbbbbbbbbbbbbbbbbbbbbbbbbbbbbbbbaaa
aaabbbbbbbbbbbbbbbbbbbbbbbbbbbbbbbbbbggjjjjjhhhhhiiiiiliiiiihhhhjjjjggggggggggkkkkkkkggbbbbbbbbbbbbbbbbbbbbbbbbbbbbbbbbbbbaaa
aaabbbbbbbbbbbbbbbbbbbbbbbbbbbbbbbbbbggjjjjjhhhhhhhhiiiiiihhhhhhjjjjggggggggggkkkkkkkggbbbbbbbbbbbbbbbbbbbbbbbbbbbbbbbbbbbaaa
aaabbbbbbbbbbbbbbbbbbbbbbbbbbbbbbbbbbggjjjjjhhhhhhhhhhhhhhhhhhhhjjjggggggkkgggkkkkkkkggbbbbbbbbbbbbbbbbbbbbbbbbbbbbbbbbbbbaaa
aaabbbbbbbbbbbbbbbbbbbbbbbbbbbbbbbbbbggjjjjjhhhhhhhhhhhhhhhhhhhjjjjggggggkkgggkkkkkkkggbbbbbbbbbbbbbbbbbbbbbbbbbbbbbbbbbbbaaa
aaabbbbbbbbbbbbbbbbbbbbbbbbbbbbbbbbbbggjjjjjhhhhhhhhhhhhhhhhhhhhjjjggggggkkgggkkkkkkkggbbbbbbbbbbbbbbbbbbbbbbbbbbbbbbbbbbbaaa
aaabbbbbbbbbbbbbbbbbbbbbbbbbbbbbbbbbbggjjjjjjjhhhhhhhhhhhhhhhhhhjjgggggggkkgggkkkkkkkggbbbbbbbbbbbbbbbbbbbbbbbbbbbbbbbbbbbaaa
aaabbbbbbbbbbbbbbbbbbbbbbbbbbbbbbbbbbggjjjjjjjhhhhhjjhhhhhhhjhhjjjgggggggkkgggggkkkggggbbbbbbbbbbbbbbbbbbbbbbbbbbbbbbbbbbbaaa
aaabbbbbbbbbbbbbbbbbbbbbbbbbbbbbbbbbbggjjjjjjjhhhhjjjjjjjhhhjhhjjjggggkkkkkgggggkkkggggggbbbbbbbbbbbbbbbbbbbbbbbbbbbbbbbbbaaa
aaabbbbbbbbbbbbbbbbbbbbbbbbbbbbbbbbgggjjjjjjjjjjjjjjjjjjjjjjjjjjggggggkgggggggggkkkggggggbbbbbbbbbbbbbbbbbbbbbbbbbbbbbbbbbaaa
aaabbbbbbbbbbbbbbbbbbbbbbbbbbbbbbbbggjjjjgjjjjjjjjjjjjjjjjjjjjjgggggggkkgggggkkkkkkkkkkggbbbbbbbbbbbbbbbbbbbbbbbbbbbbbbbbbaaa
aaabbbbbbbbbbbbbbbbbbbbbbbbbbbbbbbbggkkggggggggggggggggggggkkgggggggggkkgggggkkkkmkkkkkggbbbbbbbbbbbbbbbbbbbbbbbbbbbbbbbbbaaa
aaabbbbbbbbbbbbbbbbbbbbbbbbbbbbbbbbggkkggggggggggggggggggggkkgggggggggkkgggggkkmkkkkkkkggbbbbbbbbbbbbbbbbbbbbbbbbbbbbbbbbbaaa
aaabbbbbbbbbbbbbbbbbbbbbbbbbbbbbbbbggkkggggggggggggggggggggkkgggggggggkkkggggkkkkkkkkkkggbbbbbbbbbbbbbbbbbbbbbbbbbbbbbbbbbaaa
aaabbbbbbbbbbbbbbbbbbbbbbggggggggggkkkkkgggggggggggggggggggkkgggggggggkkkggggggggkkggggggbbbbbbbbbbbbbbbbbbbbbbbbbbbbbbbbbaaa
aaabbbbbbbbbbbbbbbbbbbbbbggggggggggknkkkggggkkkkkkkkkkkkkkkkggggggggggkkkggggggggkkggggggbbbbbbbbbbbbbbbbbbbbbbbbbbbbbbbbbaaa
aaabbbbbbbbbbbbbbbbbbbbbbggkkkkkkkkkkkkkggggkkkkkkkkkkkkkkkkggggggggggkkkggggggggkkggbbbbbgggggggbbbbbbbbbbbbbbbbbbbbbbbbbaaa
aaabbbbbbbbbbbbbbbbbbbbbbggkkkkkkkkkknnkggggkkggkkggggggggkkgkkkkkkgggknkkgggggggkkggbbbbbgggggggggggggggbbbbbbbbbbbbbbbbbaaa
aaabbbbbbbbbbbbbbbbbbbbbbggkkggggggkkkkkggggkkggkkggggggggkkgkknkkkgggkkkkgggggggkkggbbbbbggkkkkkggggggggbbbbbbbbbbbbbbbbbaaa
aaabbbbbbbbbbbbbbbbbbbbbbggkkggggggkkkkkggggkkggkkkkkkkkkgkkgkkkkokgggkkkkgggggggkkggbbbbbggkkkkkkkkkkkkggggggggggggbbbbbbaaa
aaabbbbbbbbbbbbbbbbbbbgggggkkgggggggkkkgggggkkggkkkkkkkkkgkkgkknkkkgggkknkgggggggkkggggggggkkkkkkkkkkkkkggggggggggggbbbbbbaaa
aaabbbbbbbbbbbbbbbbbbbgggggkkgggggggkkkgggggkkggkkgggggkkgkkgkkkkkkgggkkkkgggggggkkggggggggkkkkkkkkkkkkkggggggggggggbbbbbbaaa
aaabbbbbbbbbbbbbbbbbbbggkkkkkkkggbggkkkgggggkkgggggggggkkgkkggggkkggggkkkkggggkkkkkkkggggggkkkkkkgggggkkkkkkkkkkkgggbbbbbbaaa
aaabbbbbbbbbbbbbbbbbbbggkkkkkkkggbggkkkgggggkkgggggggggkkgkkggggkkgggggkkgggggkkkkkkkkkkkkkkkgggggggggkkkkkkkkkkkgggbbbbbbaaa
aaabbbbbbbbbbbbbbbbbbbggkpkkpkkggbgggkkgggggkkgggggggggkkgkkggggkkggggkkkkggggkkkqkkkkkkkkkkkgggggggggkkrkkkrkkkkgggbbbbbbaaa
aaabbbbbbbbbbbbbbbbbbbggkkkkkkkggbggkkkkkkkkkkgggkkkkkkkkgkkkkkkkkggggkskkggggkkkkkkkgggggggggggggggggkkkkkkkktkkgggbbbbbbaaa
aaabbbbbbbbbbbbbbbbbbbggkkkkkkkggbggkkkkkkkkkkgggkkukkkkkgkkkkkkkkggggkskkggggkkkkkkkgggggggggggggggggkkkkkrkkkkkgggbbbbbbaaa
aaabbbbbbbbbbbbbbbbbbbggkkkkkkkggbggkkpkkkkkkggggskkkkgkkgkkggkkggggggkkkkggggggkkgkkkkkkkkkkkkkkkkkkkkkkkkkkkkkkgggbbbbbbaaa
aaabbbbbbbbbbbbbbbbbbbggggkkgggggbggkkkkpkkkkggggkknkkgkkgkkggkkggggggkkkkggggggkkgkkkkkkkkkkkkkkkkkkkkkkkkkkkkkkgggbbbbbbaaa
aaabbbbbbbbbbbbbbbbbbbggggkkgggggbggkkkkkkkkkggggkkkkkgkkgkkggkkgggggggkkgggggggkkggggggggggggggggggggggggggggggggggbbbbbbaaa
aaabbbbbbbbbbbbbbbbbbbbbggkkggbbbbggkkkkkkkkkggggkkkkkgkkkkkggkkgggggggkkgggggggkkgggkggggggggggggggggggggggggggggggbbbbbbaaa
aaabbbbbbbbbbbbbbbbbbbbbggkkggbbbbggggkkgggggggggkkkkkgkkkkkggkkkkkkkkkkkkkkkkkkkkkkkkggggggggggggggggggggggggggggggbbbbbbaaa
aaabbbbbbbbbbbbbbbbbbbbbggkkggbbbbggggkkggggggggggkkggggggkkggkkkkkkkkkkkkkkkkkkkkkkkkggbbbbbbbbbbbbbbbbbbbbbbbbbbbbbbbbbbaaa
aaabbbbbbbbbbbbbbbbbbbbbggkkggbbbbbbggkkgkkkkkkgggkkggggggggggkkggggkkkkgggggggggggggkggbbbbbbbbbbbbbbbbbbbbbbbbbbbbbbbbbbaaa
aaabbbbbbbbbbbbbbbbbbbbbggkkggbbbbbbggkkgkkkkkkgggkkggggggggggkkggggkkkkggggggggggggggggbbbbbbbbbbbbbbbbbbbbbbbbbbbbbbbbbbaaa
aaabbbbbbbbbbbbbbbbbbbbbggkkggbbbbbbggkkgkkvkkkkkkkkgggbbbbbggkkggggkkkkggbbbbbbbbbbggggbbbbbbbbbbbbbbbbbbbbbbbbbbbbbbbbbbaaa
aaabbbbbbbbbbbbbbbbbbgggggkkggggggggggkkgkkkkkkgggkkggbbbbbbggkkggggknkkggbbbbbbbbbbbbbbbbbbbbbbbbbbbbbbbbbbbbbbbbbbbbbbbbaaa
aaabbbbbbbbbbbbbbbbbbgggggkkggggggggggkkggggggggggkkggbbbbbbggkkggggkkkkggbbbbbbbbbbbbbbbbbbbbbbbbbbbbbbbbbbbbbbbbbbbbbbbbaaa
aaabbbbbbbbbbbbbbbbbbggkkkkkkkkkkkkkkkkkkgggggggggkkggbbbbbbggkkggggkkkkggbbbbbbbbbbbbbbbgggggggggbbbbbbbbbbbbbbbbbbbbbbbbaaa
aaabbbbbbbbbbbbbbbbbbggkkkkkkkkkkkkkkkkkkgggggggggkkgggbbbbgggkkggggknkkggggggggggggggggggggggggggbbbbbbbbbbbbbbbbbbbbbbbbaaa
aaabbbbbbbbbbbbbbbbbbggkkkkkkkkkkkkkkkkkkggggggkkkkkkgggggggkkkkkkkgkkkkggggggggggggggggggkkkkkkggbbbbbbbbbbbbbbbbbbbbbbbbaaa
aaabbbbbbbbbbbbbbbbbbggkkkkkkkkkkkkkkkkkkggggggkkkkkkgggggggkkkkkkkgkkkkkkkkkkkkkkkkkkkkkkkkknkkggbbbbbbbbbbbbbbbbbbbbbbbbaaa
aaabbbbbbbbbbbbbbbbbbggkkkkkkkkkkkkkkkkkkkkkkkkkknkkkkkkkkkkkkkkkkkgkkkkkkkkkkkkkkkkkkkkkkknkkkkggbbbbbbbbbbbbbbbbbbbbbbbbaaa
aaabbbbbbbbbbbbbbbbbbggkkkkkkkkwkkkkkkkkkkkkkkkkkkkkkkkkkkkkkkkpkkkgkkkkggggkkggggggggggggkkknkkggbbbbbbbbbbbbbbbbbbbbbbbbaaa
aaabbbbbbbbbbbbbbbbbbggkkkkkkkkkkkxkkkkkkggggggkkkkkkgggggggkkkkkkkgkkkkggggkkggggggggggggggggggggbbbbbbbbbbbbbbbbbbbbbbbbaaa
aaabbbbbbbbbbbbbbbbbbggkkkkkkkkkykkkkkkkkggggggggkkgggggggggkkkkkkkgkkkkggggkkggggggggggggggggggggggggggggggbbbbbbbbbbbbbbaaa
aaabbbbbbbbbbbbbbbbbbggkkkkkkkkkkkkzkkkkkggbbbgggkkggbbbbbbgkkkkkkkgkkkkggggkkggggggggggggbbbgggggggggggggggbbbbbbbbbbbbbbaaa
aaabbbbbbbbbbbbbbbbbbggkkkkkkkkkkkkkkkkkkggbbbbggkkggbbbbbbgggggggggkkkkggggkkggggggggggggbbbggkkkkkkkkkkkggbbbbbbbbbbbbbbaaa
aaabbbbbbbbbbbbbbbbbbggkkkkkkkkkkkkkkkkkkggbbbbggkkggggggbbgggggggggkkkkggggkkggggggggggggbbbggkkkABkkkkkkggbbbbbbbbbbbbbbaaa
aaabbbbbbbbbbbbbbbbbbggkkkkkkkkkkkkkkkkkkggbbbgggkkggggggbbbbbbbbbggnkkkggggkkggggggggggggbbbggkkkkkkkkkkkggbbbbbbbbbbbbbbaaa
aaabbbbbbbbbbbbbbbbbbggggggggggggggggggggggbbggkkkkkkkkggbbbbbbbbbggkkkkggggkkgggggggggggggggggkkkkkkkkkkkggbbbbbbbbbbbbbbaaa
aaabbbbbbbbbbbbbbbbbbggggggggggggggggggggggbbggkknkkkkkggbbbbbbbbbggkkkkggggkkgggggggggggggggggkkkkkkkkkkkggbbbbbbbbbbbbbbaaa
aaabbbbbbbbbbbbbbbbbbbbbbbbbbbbbbbbbbbbbbbbbbggkkknkkkkggbbbbbbbbbggkkkkggggkkkkkkkkkkkkkkkkkkkkkkkkCkkkkkggbbbbbbbbbbbbbbaaa
aaabbbbbbbbbbbbbbbbbbbbbbbbbbbbbbbbbbbbbbbbbbggkkkkkkkkggbbbbbbbbbggkknkggggkkkkkkkkkkkkkkkkkkkkkkkkkkkkkkggbbbbbbbbbbbbbbaaa
aaabbbbbbbbbbbbbbbbbbbbbbbbbbbbbbbbbbbbbbbbbbggkkkkkpkkggbbbbbbbbbggkkkkggggkkgggggggggggggggggkkkkkkkkkkkggbbbbbbbbbbbbbbaaa
aaabbbbbbbbbbbbbbbbbbbbbbbbbbbbbbbbbbbbbbbbbbggkkkkkkkkggbbbbbbbbbggkkkkggggkkgggggggggggggggggkkkkkkkkkkkggbbbbbbbbbbbbbbaaa
aaabbbbbbbbbbbbbbbbbbbbbbbbbbbbbbbbbbbbbbbbbbggkkkkkkkkggbbbbbbbbbggkkkkggggggggbbbbbbbbbbbbbggkkkkkkkkkkkggbbbbbbbbbbbbbbaaa
aaabbbbbbbbbbbbbbbbbbbbbbbbbbbbbbbbbbbbbbbbbbbgggggkkggggbbbbbbbbbggkkkkggbggggbbbbbbbbbbbbbbgggggggggggggggbbbbbbbbbbbbbbaaa
aaabbbbbbbbbbbbbbbbbbbbbbbbbbbbbbbbbbbbbbbbbbbgggggkkgggggggggggggggkkkkggbbbbbbbbbbbbbbbbbbbgggggggggggggggbbbbbbbbbbbbbbaaa
aaabbbbbbbbbbbbbbbbbbbbbbbbbbbbbbbbbbbbbbbbbbbgggggkkgggggggggggggggkkkkggbbbbbbbbbbbbbbbbbbbbbbbbbbbbbbbbbbbbbbbbbbbbbbbbaaa
aaabbbbbbbbbbbbbbbbbbbbbbbbbbbbbbbbbbbbbbbbbbggkkkgkkgkkkkkkkkkkkkkkkkkkggbbbbbbbbbbbbbbbbbbbbbbbbbbbbbbbbbbbbbbbbbbbbbbbbaaa
aaabbbbbbbbbbbbbbbbbbbbbbbbbbbbbbbbbbbbbbbbbbggkkkkkkkkkkkkknkkkkkkkkkkkggbbbbbbbbbbbbbbbbbbbbbbbbbbbbbbbbbbbbbbbbbbbbbbbbaaa
aaabbbbbbbbbbbbbbbbbbbbbbbbbbbbbbbbbbbbbbbbbbggkkkgkkgkkkkkkkkkkkkkkkkkkggbbbbbbbbbbbbbbbbbbbbbbbbbbbbbbbbbbbbbbbbbbbbbbbbaaa
aaabbbbbbbbbbbbbbbbbbbbbbbbbbbbbbbbbbbbbbbbbbggkkggkkgggggggggggggggggggggbbbbbbbbbbbbbbbbbbbbbbbbbbbbbbbbbbbbbbbbbbbbbbbbaaa
aaabbbbbbbbbbbbbbbbbbbbbbbbbbbbbbbbbbbbbbbbbbggkkggkkgggggggggggggggggggggbbbbbbbbbbbbbbbbbbbbbbbbbbbbbbbbbbbbbbbbbbbbbbbbaaa
aaabbbbbbbbbbbbbbbbbbbbbbbbbbbbbbbbbbbbbbbbbbggkkggkkggbbbbbbbbbbbbbbbbbbbbbbbbbbbbbbbbbbbbbbbbbbbbbbbbbbbbbbbbbbbbbbbbbbbaaa
aaabbbbbbbbbbbbbbbbbbbbbbbbbbbbbbbbbbbbbbbbbbggkkggkkggbbbbbbbbbbbbbbbbbbbbbbbbbbbbbbbbbbbbbbbbbbbbbbbbbbbbbbbbbbbbbbbbbbbaaa
aaabbbbbbbbbbbbbbbbbbbbbbbbbbbbbbbgggggggggggggkkggkkggbbbbbbbbbbbbbbbbbbbbbbbbbbbbbbbbbbbbbbbbbbbbbbbbbbbbbbbbbbbbbbbbbbbaaa
aaabbbbbbbbbbbbbbbbbbbbbbbbbbbbbbbgggggggggggggkkggkkggggggggggggggggggggggggggggggggggggggbbbbbbbbbbbbbbbbbbbbbbbbbbbbbbbaaa
aaabbbbbbbbbbbbbbbbbbbbbbbbbbbbbbbggkkkkkkkkkkkkkgggDggggggggggggggggggggggggggggggggggggggbbbbbbbbbbbbbbbbbbbbbbbbbbbbbbbaaa
aaabbbbbbbbbbbbbbbbbbbbbbbbbbbbbbbggkkkkkkkkkkkkkggkkkkkkkkkkkkkkkkkkkkkkkkkkkkkkkkkkkkkkggbbbbbbbbbbbbbbbbbbbbbbbbbbbbbbbaaa
aaabbbbbbbbbbbbbbbbbbbbbbbbbbbbbbbggkkkkkkgggggggggkkkkkkkkkkkkkkkkkkkkkkkkkkkkkkkkkkkkkkggbbbbbbbbbbbbbbbbbbbbbbbbbbbbbbbaaa
aaabbbbbbbbbbbbbbbbbbbbbbbbbbbbbbbggkkkkkkgggggggggkkkkkknkkkkkkkkkkkkkkkkkkkkkkkkkkkkkkkggbbbbbbbbbbbbbbbbbbbbbbbbbbbbbbbaaa
aaabbbbbbbbbbbbbbbbbbbbbbbbbbbbbbbggknkpkkgggggggggkkkkkkkkkkkkkkkkkkkkkkkkkkkkkkkkkkkkkkggbbbbbbbbbbbbbbbbbbbbbbbbbbbbbbbaaa
aaabbbbbbbbbbbbbbbbbbbbbbbbbbbbbbbggkkEkkkgggggggggknkkkkkkkkkkkkkkkkkkkkkkkkkkkkkkkkkkkkggbbbbbbbbbbbbbbbbbbbbbbbbbbbbbbbaaa
aaabbbbbbbbbbbbbbbbbbbbbbbbbbbbbbbggkkkkkkgggggggggkkkkkkkkkkkkkkkkkkkkkkkkkkkkkkkkkkkkkkggbbbbbbbbbbbbbbbbbbbbbbbbbbbbbbbaaa
aaabbbbbbbbbbbbbbbbbbbbbbbbbbbbbbbgggggggggggggggggkkkkkkkkkkkkkkkkkkkkkkkkkkkkkkkkkkkkkkggbbbbbbbbbbbbbbbbbbbbbbbbbbbbbbbaaa
aaabbbbbbbbbbbbbbbbbbbbbbbbbbbbbbbgggggggggggggggggkkkkkkkkkkkkkkkkkkkkkkkkkkkkkkkkkkkkkkggbbbbbbbbbbbbbbbbbbbbbbbbbbbbbbbaaa
aaabbbbbbbbbbbbbbbbbbbbbbbbbbbbbbbgggggggggggggggggkkkkkkkkkkkkkkkkkkkkkkkkkkkkkkkkkkkkkkggbbbbbbbbbbbbbbbbbbbbbbbbbbbbbbbaaa
aaabbbbbbbbbbbbbbbbbbbbbbbbbbbbbbbgggggggggggggggggkkkkkkkkkkkkkkkkkkkkkkkkkkkkkkkkkkkkkkggbbbbbbbbbbbbbbbbbbbbbbbbbbbbbbbaaa
aaabbbbbbbbbbbbbbbbbbbbbbbbbbbbbbbbbbbbggggggggggggkkkkkkkkkkkkkkkkkkkkkkkkkkkkkkkkkkkkkkggbbbbbbbbbbbbbbbbbbbbbbbbbbbbbbbaaa
aaabbbbbbbbbbbbbbbbbbbbbbbbbbbbbbbbbbbbbgggggggggggkkkkkkkkkkkkkkkkkkkkkkkkkkkkkkkkkkkkkkggbbbbbbbbbbbbbbbbbbbbbbbbbbbbbbbaaa
aaabbbbbbbbbbbbbbbbbbbbbbbbbbbbbbbbbbbbbbbbbbbbbbggkkkkkkkkkkkkkkkkkkkkkkkkkkkkkkkkkkkkkkggbbbbbbbbbbbbbbbbbbbbbbbbbbbbbbbaaa
aaabbbbbbbbbbbbbbbbbbbbbbbbbbbbbbbbbbbbbbbbbbbbbbggkkkkkkkkkkkkkkkkkkkkkkkkkkkkkkkkkkkkkkggbbbbbbbbbbbbbbbbbbbbbbbbbbbbbbbaaa
aaabbbbbbbbbbbbbbbbbbbbbbbbbbbbbbbbbbbbbbbbbbbbbbggkkkkkkkkkkkkkkkkkkkkkkkkkkkkkkkkkkkkkkggbbbbbbbbbbbbbbbbbbbbbbbbbbbbbbbaaa
aaabbbbbbbbbbbbbbbbbbbbbbbbbbbbbbbbbbbbbbbbbbbbbbggkkkkkkkkkkkkkkkkkkFkkkkkkkkkkkkkkkkkkkggbbbbbbbbbbbbbbbbbbbbbbbbbbbbbbbaaa
aaabbbbbbbbbbbbbbbbbbbbbbbbbbbbbbbbbbbbbbbbbbbbbbggkkkkkkkkkkkkkkkkkkGkkkkkkkkkkkkkkkkkkkggbbbbbbbbbbbbbbbbbbbbbbbbbbbbbbbaaa
aaabbbbbbbbbbbbbbbbbbbbbbbbbbbbbbbbbbbbbbbbbbbbbbggkkkkkkkkkkkkkkkkkkkkkkkkkkkkkkkkkkkkkkggbbbbbbbbbbbbbbbbbbbbbbbbbbbbbbbaaa
aaabbbbbbbbbbbbbbbbbbbbbbbbbbbbbbbbbbbbbbbbbbbbbbggkkkkkkkkkkkkkkkkkkkkkkkkkkkkkkkkkkkkkkggbbbbbbbbbbbbbbbbbbbbbbbbbbbbbbbaaa
aaabbbbbbbbbbbbbbbbbbbbbbbbbbbbbbbbbbbbbbbbbbbbbbggkkkkkkkkkkkkkkkkkkkkkkkkkkkkkkkkkkkkkkggbbbbbbbbbbbbbbbbbbbbbbbbbbbbbbbaaa
aaabbbbbbbbbbbbbbbbbbbbbbbbbbbbbbbbbbbbbbbbbbbbbbgggggHggggggggggggggggggggggggggggggggggggbbbbbbbbbbbbbbbbbbbbbbbbbbbbbbbaaa
aaabbbbbbbbbbbbbbbbbbbbbbbbbbbbbbbbbbbbbbbbbbbbbbggggkkkgggggggggggggggggggggggggggggggggggbbbbbbbbbbbbbbbbbbbbbbbbbbbbbbbaaa
aaabbbbbbbbbbbbbbbbbbbbbbbbbbbbbbbbbbbbbbbbbbbbbbbbggkkkgggbbbbbbbbbbbbbbbbbbbbbbbbbbbbbbbbbbbbbbbbbbbbbbbbbbbbbbbbbbbbbbbaaa
aaabbbbbbbbbbbbbbbbbbbbbbbbbbbbbbbbbbbbbbbbbbbbbbbbggkIkgggbbbbbbbbbbbbbbbbbbbbbbbbbbbbbbbbbbbbbbbbbbbbbbbbbbbbbbbbbbbbbbbaaa
aaabbbbbbbbbbbbbbbbbbbbbbbbbbbbbbbbbbbbbbbbbbbbbbbbggkIkgggbbbbbbbbbbbbbbbbbbbbbbbbbbbbbbbbbbbbbbbbbbbbbbbbbbbbbbbbbbbbbbbaaa
aaabbbbbbbbbbbbbbbbbbbbbbbbbbbbbbbbbbbbbbbbbbbbbbbbggkkkgggbbbbbbbbbbbbbbbbbbbbbbbbbbbbbbbbbbbbbbbbbbbbbbbbbbbbbbbbbbbbbbbaaa
aaabbbbbbbbbbbbbbbbbbbbbbbbbbbbbbbbbbbbbbbbbbbbbbbbggkkkgggbbbbbbbbbbbbbbbbbbbbbbbbbbbbbbbbbbbbbbbbbbbbbbbbbbbbbbbbbbbbbbbaaa
aaabbbbbbbbbbbbbbbbbbbbbbbbbbbbbbbbbbbbbbbbbbbbbbbbggkkkgggbbbbbbbbbbbbbbbbbbbbbbbbbbbbbbbbbbbbbbbbbbbbbbbbbbbbbbbbbbbbbbbaaa
aaabbbbbbbbbbbbbbbbbbbbbbbbbbbbbbbbbbbbbbbbbbbbbbbbggkkkgggbbbbbbbbbbbbbbbbbbbbbbbbbbbbbbbbbbbbbbbbbbbbbbbbbbbbbbbbbbbbbbbaaa
aaabbbbbbbbbbbbbbbbbbbbbbbbbbbbbbbbbbbbbbbbbbbbbbbbggkkkgggbbbbbbbbbbbbbbbbbbbbbbbbbbbbbbbbbbbbbbbbbbbbbbbbbbbbbbbbbbbbbbbaaa
aaabbbbbbbbbbbbbbbbbbbbbbbbbbbbbbbbbbbbbbbbbbbbbbbbggkkkgggbbbbbbbbbbbbbbbbbbbbbbbbbbbbbbbbbbbbbbbbbbbbbbbbbbbbbbbbbbbbbbbaaa
aaabbbbbbbbbbbbbbbbbbbbbbbbbbbbbbbbbbbbbbbbbbbbbbbbggkkkgggbbbbbbbbbbbbbbbbbbbbbbbbbbbbbbbbbbbbbbbbbbbbbbbbbbbbbbbbbbbbbbbaaa
aaabbbbbbbbbbbbbbbbbbbbbbbbbbbbbbbbbbbbbbbbbbbbbbbbggkkkgggbbbbbbbbbbbbbbbbbbbbbbbbbbbbbbbbbbbbbbbbbbbbbbbbbbbbbbbbbbbbbbbaaa
aaabbbbbbbbbbbbbbbbbbbbbbbbbbbbbbbbbbbbbbbbbbbbbbbbggkkkgggbbbbbbbbbbbbbbbbbbbbbbbbbbbbbbbbbbbbbbbbbbbbbbbbbbbbbbbbbbbbbbbaaa
aaabbbbbbbbbbbbbbbbbbbbbbbbbbbbbbbbbbbbbbbbbbbbbbbbggkkkgggbbbbbbbbbbbbbbbbbbbbbbbbbbbbbbbbbbbbbbbbbbbbbbbbbbbbbbbbbbbbbbbaaa
aaabbbbbbbbbbbbbbbbbbbbbbbbbbbbbbbbbbbbbbbbbbbbbbbbggkkkgggbbbbbbbbbbbbbbbbbbbbbbbbbbbbbbbbbbbbbbbbbbbbbbbbbbbbbbbbbbbbbbbaaa
aaabbbbbbbbbbbbbbbbbbbbbbbbbbbbbbbbbbbbbbbbbbbbbbbggkkkkkggbbbbbbbbbbbbbbbbbbbbbbbbbbbbbbbbbbbbbbbbbbbbbbbbbbbbbbbbbbbbbbbaaa
aaabbbbbbbbbbbbbbbbbbbbbbbbbbbbbbbbbbbbbbbbbbbbbbbggkkkkkggbbbbbbbbbbbbbbbbbbbbbbbbbbbbbbbbbbbbbbbbbbbbbbbbbbbbbbbbbbbbbbbaaa
aaabbbbbbbbbbbbbbbbbbbbbbbbbbbbbbbbbbbbbbbbbbbbbbbggkkkkkggbbbbbbbbbbbbbbbbbbbbbbbbbbbbbbbbbbbbbbbbbbbbbbbbbbbbbbbbbbbbbbbaaa
aaabbbbbbbbbbbbbbbbbbbbbbbbbbbbbbbbbbbbbbbbbbbbbbbggkkkkkggbbbbbbbbbbbbbbbbbbbbbbbbbbbbbbbbbbbbbbbbbbbbbbbbbbbbbbbbbbbbbbbaaa
aaabbbbbbbbbbbbbbbbbbbbbbbbbbbbbbbbbbbbbbbbbbbbbbbbaaeeeaabbbbbbbbbbbbbbbbbbbbbbbbbbbbbbbbbbbbbbbbbbbbbbbbbbbbbbbbbbbbbbbbaaa
aaabbbbbbbbbbbbbbbbbbbbbbbbbbbbbbbbbbbbbbbbbbbbbbbbaaeeeaabbbbbbbbbbbbbbbbbbbbbbbbbbbbbbbbbbbbbbbbbbbbbbbbbbbbbbbbbbbbbbbbaaa
aaabbbbbbbbbbbbbbbbbbbbbbbbbbbbbbbbbbbbbbbbbbbbbbbbaaefeaabbbbbbbbbbbbbbbbbbbbbbbbbbbbbbbbbbbbbbbbbbbbbbbbbbbbbbbbbbbbbbbbaaa
aaaaaaaaaaaaaaaaaaaaaaaaaaaaaaaaaaaaaaaaaaaaaaaaaaaaaaaaaaaaaaaaaaaaaaaaaaaaaaaaaaaaaaaaaaaaaaaaaaaaaaaaaaaaaaaaaaaaaaaaaaaaa
aaaaaaaaaaaaaaaaaaaaaaaaaaaaaaaaaaaaaaaaaaaaaaaaaaaaaaaaaaaaaaaaaaaaaaaaaaaaaaaaaaaaaaaaaaaaaaaaaaaaaaaaaaaaaaaaaaaaaaaaaaaaa
aaaaaaaaaaaaaaaaaaaaaaaaaaaaaaaaaaaaaaaaaaaaaaaaaaaaaaaaaaaaaaaaaaaaaaaaaaaaaaaaaaaaaaaaaaaaaaaaaaaaaaaaaaaaaaaaaaaaaaaaaaaaa
"}
