"a" = (/turf/UnbreakableTurfs/Void_Wall,/area/Outside)
"b" = (/turf/Other/Blank,/area/Outside)
"c" = (/turf/Stairs1,/area/Outside)
"d" = (/obj/dungeon_exit,/turf/Stairs1,/area/Outside)
"e" = (/turf/Stairs4,/area/Outside)
"f" = (/obj/dungeon_exit{isClearingExit = 1},/turf/Stairs4,/area/Outside)
"g" = (/turf/Ground/Ground10,/area/Outside)
"h" = (/turf/Water3,/area/Outside)
"i" = (/obj/Boat{SaveItem = 0},/turf/Water3,/area/Outside)
"j" = (/mob/npc/Enemy/Tiger_Bandit,/turf/Ground/Ground10,/area/Outside)
"k" = (/mob/npc/Enemy/Bandit,/turf/Ground/Ground10,/area/Outside)
"l" = (/mob/npc/Enemy/Bosses/Golem,/turf/Ground/Ground10,/area/Outside)
"m" = (/turf/Door/Door5{password = "BDOOR412"},/area/Outside)
"n" = (/mob/npc/Enemy/Bosses/Lost_Soldier,/turf/Ground/Ground10,/area/Outside)
"o" = (/mob/npc/Enemy/Bosses/Nauscent_Immortal,/turf/Ground/Ground10,/area/Outside)
"p" = (/obj/items/Key{password = list("BDOOR412')")},/turf/Ground/Ground10,/area/Outside)
"q" = (/obj/items/Smoke_Bomb,/turf/Ground/Ground10,/area/Outside)
"r" = (/obj/items/Rebreather,/turf/Ground/Ground10,/area/Outside)
"s" = (/obj/items/Research_Book{IntPower = 50},/turf/Ground/Ground10,/area/Outside)
"t" = (/obj/items/food/Fish,/turf/Ground/Ground10,/area/Outside)
"u" = (/obj/items/food/Yemma_Fruit,/turf/Ground/Ground10,/area/Outside)
"v" = (/obj/items/Equipment/Weapon/Hammer/Warhammer,/turf/Ground/Ground10,/area/Outside)
"w" = (/obj/items/food/Apple_Of_Eden,/turf/Ground/Ground10,/area/Outside)
"x" = (/obj/items/Guns/Rocket_Launcher,/turf/Ground/Ground10,/area/Outside)
"y" = (/obj/items/Anti_Virus/Anti_Virus_Delta,/turf/Ground/Ground10,/area/Outside)
"z" = (/obj/Zenni{name = "125000 Zenni"; zenni = 125000},/turf/Ground/Ground10,/area/Outside)

(1,1,1) = {"
aaaaaaaaaaaaaaaaaaaaaaaaaaaaaaaaaaaaaaaaaaaaaaaaaaaaaaaaaaaaaaaaaaaaaaaaaaaaaaaaaaaaaaaaaaaaaaaaaaaaaaaaaaaaaaaaaaaaaaaaaaaaa
aaaaaaaaaaaaaaaaaaaaaaaaaaaaaaaaaaaaaaaaaaaaaaaaaaaaaaaaaaaaaaaaaaaaaaaaaaaaaaaaaaaaaaaaaaaaaaaaaaaaaaaaaaaaaaaaaaaaaaaaaaaaa
aaaaaaaaaaaaaaaaaaaaaaaaaaaaaaaaaaaaaaaaaaaaaaaaaaaaaaaaaaaaaaaaaaaaaaaaaaaaaaaaaaaaaaaaaaaaaaaaaaaaaaaaaaaaaaaaaaaaaaaaaaaaa
aaabbbbbbbbbbbbbbbbbbbbbbbbbbbbbbbbbbbbbbbbbbbbbbbbbacccabbbbbbbbbbbbbbbbbbbbbbbbbbbbbbbbbbbbbbbbbbbbbbbbbbbbbbbbbbbbbbbbbaaa
aaabbbbbbbbbbbbbbbbbbbbbbbbbbbbbbbbbbbbbbbbbbbbbbbbbacdcabbbaaabbbbbbbbbbbbbbbbbbbbbbbbbbbbbbbbbbbbbbbbbbbbbbbbbbbbbbbbbbbaaa
aaabbbbbbbbbbbbbbbbbbbbbbbbbbbbbbbbbbbbbbbbbbbaaaaabacccabaaagaaaabbbbbbbbbbbbbbbbbbbbbbbbbbbbbbbbbbbbbbbbbbbbbbbbbbbbbbbbaaa
aaabbbbbbbbbbbbbbbbbbbbbbbbbbbbbbbbbbbbbbbbbbaagggaaacccaaaggggggaaabbbbbbbbbbbbbbbbbbbbbbbbbbbbbbbbbbbbbbbbbbbbbbbbbbbbbbaaa
aaabbbbbbbbbbbbbbbbbbbbbbbbbbbbbbbbbbbbbbbbbbaggggggggggggggggggggaabbbbbbbbbbbbbbbbbbbbbbbbbbbbbbbbbbbbbbbbbbbbbbbbbbbbbbaaa
aaabbbbbbbbbbbbbbbbbbbbbbbbbbbbbbbbbbbbbbbbbaaggggggggggggggggggggabbbbbbbbbbbbbbbbbbbbbbbbbbbbbbbbbbbbbbbbbbbbbbbbbbbbbbbaaa
aaabbbbbbbbbbbbbbbbbbbbbbbbbbbbbbbbbbbbbbbbaagggggggggggggggggggggabbbbbbbbbbbbbbbbbbbbbbbbbbbbbbbbbbbbbbbbbbbbbbbbbbbbbbbaaa
aaabbbbbbbbbbbbbbbbbbbbbbbbbbbbbbbbbbbbbbbbaggggggggggggggggggggggaaabbbbbbbbbbbbbbbbbbbbbbbbbbbbbbbbbbbbbbbbbbbbbbbbbbbbbaaa
aaabbbbbbbbbbbbbbbbbbbbbbbbbbbbbbbbbbbbbbbbaaaggggggggggggggggggggggaaaaaaaaaabbaaaaaaaabbbbbbbbbbbbbbbbbbbbbbbbbbbbbbbbbbaaa
aaabbbbbbbbbbbbbbbbbbbbbbbbbbbbbbbbbbbbbbbbbbaagggggggggggggggggggggggggggggabbbaggggggaabbbbbbbbbbbbbbbbbbbbbbbbbbbbbbbbbaaa
aaabbbbbbbbbbbbbbbbbbbbbbbbbbbbbbbbbbbbbbbbbbaggggggggggggggggggggggggggggggaaabagggjggaabbbbbbbbbbbbbbbbbbbbbbbbbbbbbbbbbaaa
aaabbbbbbbbbbbbbbbbbbbbbbbbbbbbbbbbbbbbbbbbbbagggggggggggggggggggggggaaggggggggaaggggggaaaaaaaaaaaaaaaaaaaaaaaaaaaaaaabbbbaaa
aaabbbbbbbbbbbbbbbbbbbbbbbbbbbbbbbbbbbbbbbbbbagggggggggggggggggggggggaagggggggggggjggggggggggggggggggggggggggggggggggabbbbaaa
aaabbbbbbbbbbbbbbbbbbbbbbbbbbbbbbbbbbbbbbbbbbaaaagggggggggggggggggggggaaaaggggggggggaagggggggggggggggggggggggggggggggabbbbaaa
aaabbbbbbbbbbbbbbbbbbbbbbbbbbbbbbbbbbbbbbbbbbbbaaaaggggggagggggggagaaaaaaaaaaaaaaaaaaagggggggggggggggggggggggggggghggabbbbaaa
aaabbbbbbbbbbbbbbbbbbbbbbbbbbbbbbbbbbbbbbbbbbbbbbbaagggaaaaagggaaaaabbbbbbbbbbbbbbbbaaggggggghhhgggggggggggggggggghggabbbbaaa
aaabbbbbbbbbbbbbbbbbbbbbbbbbbbbbbbbbbbbbbbbbbbbbbbbagggabbbaaaaabbbbbbbbbbbbbbbbbbbbaahhhhhhhhhhhhhhhihhhhhhhhhhhhhhhabbbbaaa
aaabbbbbbbbbbbbbbbbbbbbbbbbbbbbbbbbbbbbbbbbbbbbbbbbagggabbbbbbbbbbbbbbbbbbbbbbbbbbbbaahhhhhhhhhhhhhhhhhhhhhhhhhhhhhhhabbbbaaa
aaabbbbbbbbbbbbbbbbbbbbbbbbbbbbbbbaaaaaaaaaaaaabbbbagggabbbbbbbbbbbbbbbbbbbbbbbbbbbbaahhhhhhhhhhhhhhhhhhhhhhhhhhhhhhhabbbbaaa
aaabbbbbbbbbbbbbbbbbbbbbbbbbbbbbbbaggggggggggaabbbbagggabbbbbbbbbbbbbbbbbbbbbbbbbbbbaahhhhhhhhhhhhhhhhhhhhhhhhhhhhhhhabbbbaaa
aaabbbbbbbbbbbbbbbbbbbbbbbbbbbbbbbagggjgqggggaabbbbagggabbbbbbbbbbbbbbbbbbbbbbbbbbbbaahhhhhhhhhhhhhhhhhhhhhhhhhhhhhhhabbbbaaa
aaabbbbbbbbbbbbbbbbbbbbbbbbbbbbbbbaggggqgqgggaabbbbagggabbbbbbbbbbbbbbbbbbbbbbbbbbbbaahhhhhhhhhhhhhhhhhhhhhhhhhhhhhhhabbbbaaa
aaabbbbbbbbbbbbbbbbbbbbbbbbbbbbbbbaggggggjgggaabbbbagggabbbbbbbbbbbbbbbbbbbbbbbbbbbbaaggghhhhhhhhhhhhhhhhhhhhhhhhhhhhabbbbaaa
aaabbbbbbbbbbbbbbbbbbbbbbbbbbbbbbbaggggggggggaabbbbagggabbbbbbbbbbbbbbbbbbbbbbbbbbbbaagggihhhhhhhhhhhhhhhhhhhhhhhhhhhabbbbaaa
aaabbbbbbbbbbbbbbbbbbbbbbbbbbbbbbbaggggggggggaabbbbagjgabbbbbbbbbbbbbbbbbbbbbbbbbbbbaaggghhhhhhhhhhhggghhhhhhhhhhhhhhabbbbaaa
aaabbbbbbbbbbbbbbbbbbbbbbbbbbbbbbbaaaaggaaaaaaaaaaaagggaaaaaaaaaaaaaaaabbbbbbbbbbbbbaahhhhhhhhhhhhhhgggghhhhhhhhhhhhhabbbbaaa
aaabbbbbbbbbbbbbbbbbbbbbbbbbbbbbbbbbbaggagggggggggggggggggggggggggggggaaaaabbbbbbbbbaahhhhhhhhhhhhhhgggghhhhhhhhhhhhhabbbbaaa
aaabbbbbbbbbbbbbbbbbbbbbbbbbbbbbbbbbbaagggggggggggggggggggggggggggggggggggaaabbbbbbbaahhhhhhhhhhhhhhhggggghhhhhhhhhhgabbbbaaa
aaabbbbbbbbbbbbbbbbbbbbbbbbbbbbbbbbbbbaagggaaaaaaaaagggaaaaaaggggjggggggggggaabbbbbbaahhhhhhhhhhhhhhhgghhhhhhhhhhhhhgabbbbaaa
aaabbbbbbbbbbbbbbbbbbbbbbbbbbbbbbbbbbbbagggggabbbbaagggaabbbagggggggggggjgggaabbbbbbaahhhhhhhhhhhhhhhhhhhhhhhhhhhhhhgabbbbaaa
aaabbbbbbbbbbbbbbbbbbbbbbbbbbbbbbbbbbbbagrgggaaabbaagggaabbbagggggggggggggggaabbbbbbaahhhhhhhhhhhhhhhhhhhhhhhhhhhhhhgabbbbaaa
aaabbbbbbbbbbbbbbbbbbbbbbbbbbbbbbbbbbbbagggjgggabbaagggaabbbagggggggggaaaaaaaabbbbbbaahhhhhhhhhhhhhhhhhhhhhhhhhhhhhggabbbbaaa
aaabbbbbbbbbbbbbbbbbbbbbbbbbbbbbbbbbbbbaaaaggggabbaagggaabbbaaaaaaaaaaaaabbbbbbbbbbbaahhhhhhhhhhhhhhhhhhhhhhhhhhhhgggabbbbaaa
aaabbbbbbbbbbbbbbbbbbbbbbbbaaaaaaaaaaaaaaaaaaaaaaaaagggaaaaaaaaaaaaaaaaaaaaaaaaabbbbaaggghhhhhhhhhhhhhhhhhhhhhhhhhhggabbbbaaa
aaabbbbbbbbbbbbbbbbbbbbbbbbaaggggggggggggggggggggggggggggggggggggggggggggggggggabbbbaaggghhhhghhhhhhhhhhhhhhhhhhhhhggabbbbaaa
aaabbbbbbbbbbbbbbbbbbbbbbbbaagggggggggggggggggggggggjggggggggggggggggggggggggggabbbbaaggghhhggghhhhhhhhhhhhhhhhhhhgggabbbbaaa
aaabbbbbbbbbbbbbbbbbbbbbbbbaaggjggggggggggggggggggggggggggggghhhhhhhhghhhhhhhggabbbbaaggghhggjgghhhhhhhhhhhhhhhhhhhggabbbbaaa
aaabbbbbbbbbbbbbbbbbbbbbbbbaagggghhhhhhhhhhhhhhhhhhhhihhhhhhhhhhhhhhhhhhhhhhhhgabbbbaaggghhhgghhhhhhhhhhhhhhhhhhhhhggabbbbaaa
aaabbbbbbbbbbbbbbbbbbbbbbbbaaggghhhhhhhhhhhhhhhhhhhhhhhhhhhhhhhhhhhhhhhhhhhhhhgabbbbaaggghhhhghhhhhhhhhhhhhhhhhhhhhhhabbbbaaa
aaabbbbbbbbbbbbbbbbbbbbbbbbaaggghhhhhhhhhhhhhhhhhhhhhhhhhhhhhhhhhhhhhhhhhhhhhhgabbbbaaggghhhhhhhhhhhhhhhhhhhhhhhhhhhhabbbbaaa
aaabbbbbbbbbbbbbbbbbbbbbbbbaagghhhhhhhhhhhhhhhhhhhhhhhhhhhhhhhhhhhhhhhhhhhhhhhgabbbbaaghhhhhhhhhhhhhhhhhhhhhhhhhhhhhhabbbbaaa
aaabbbbbbbbbbbbbbbbbbbbbbbbaaggihhhhhhhhhhhhhhhhhhhhhhhhhhhhhhhhhhhhhhhhhhhhhhgabbbbaaghhhhhhhhhhhhhhhhhhhhhhhhhhhhhhabbbbaaa
aaabbbbbbbbbbbbbbbbbbbbbbbbaaggghhhhhhhhhhhhhhhhhhhhhhhhhhhhhhhhhhhhhhhhhhhhhhgabbbbaaghhhhhhhhhhhhhhhhhhhhhhhhhhhhhgabbbbaaa
aaabbbbbbbbbbbbbbbbbbbbbbbbaagghhhhhhhhhhhhhhhhhhhhhhhhhhhhhhhhhhhhhhhhhhhhhhhgabbbbaahhhhhhhhhhhhhhhhhhhhhhhhhhhhhhgabbbbaaa
aaabbbbbbbbbbbbbbbbbbbbbbbbaaghhhhhhhhhhhhhhhhhhhhhhhhhhhhhhhhhhhhhhhhhhhhhhhhhabbbbaahhhhhhhhhhhhhhhhhhhhhhhhhhhhhhgabbbbaaa
aaabbbbbbbbbbbbbbbbbbbbbbbbaahhhhhhhhhhhhhhhhhhhhhhhhhhhhhhhhhhhhhhhhhhhhhhhhhhabbbbaahhhhhhhhhhhhhhhhhhhhhhhhhhhhgggabbbbaaa
aaabbbbbbbbbbbbbbbbbbbbbbbbaahhhhhhhhhhhhhgghghhhhhhhhhhhhhhhhhhhhhhhhhhhhhhhhhabbbbaahhhhhhhhhhhhhhhhhhhhhhhhhhhhgggabbbbaaa
aaabbbbbbbbbbbbbbbbbbbbbbbbaahhhhhhhhhhhhhggghhhhhhhhhhhhhhhhhhhhhhhhhhhhhhhhhhabbbbaaghhhhhhhhhhhhhhhhhhhhhhhhhhhgggabbbbaaa
aaabbbbbbbbbbbbbbbbbbbbbbbbaahhhhhhhhhhhhggggghhhhhhhhhhhhhhhhhhhhhhhhhhhhhhhhhabbbbaaghhhhhhhhhhhhhhhhhhhhhhhhhhhggjabbbbaaa
aaabbbbbbbbbbbbbbbbbbbbbbbbaahhhhhhhhhhhhhggghghhhhhhhhhhhhhhhhhhhhhhhhhhhhhhhhabbbbaaghhhhhhhhhhhhhhhhhhhhhhhhhhhgggabbbbaaa
aaabbbbbbbbbbbbbbbbbbbbbbbbaahhhhhhhhhhhhhhhhhhhhhhhhhhhhhhhhhhhhhhhhhhhhhhhhhhabbbbaaggghhhhhhhhhhhhhhhhhhhhhhhhhgggabbbbaaa
aaabbbbbbbbbbbbbbbbbbbbbbbbaahhhhhhhhhhhhhhhhhhhhhhhhhhhhhhhhhhhhhhhhhhhhhhhhhhabbbbaaggghhhhhhhhhhhhhhhhhhhhhhhhhgggabbbbaaa
aaabbbbbbbbbbbbbbbbbbbbbbbbaahhhhhhhhhhhhhhhhhhhhhhhhhhhhhhhhhhhhhhhhhhhhhhhhhhabbbbaaggghhhhhhhhhhhhhhhhhhhhhhhhhgggabbbbaaa
aaabbbbbbbbbbbbbbbbbbbbbbbbaahhhhhhhhhhhhhhhhhhhhhhhhhhhhhhhhhhhhhhhhhhhhhhhhhhabbbbaagsghhhhhhhhhhhhhhhhhhhhhhhhhgggabbbbaaa
aaabbbbbbbbbbbbbbbbbbbbbbbbaahhhhhhhhhhhhhhhhhhhhhhhhhhhhhhhhhhhhhhhhhhhhhhhhhhabbbbaaggghhhhhhhhhhhhhhhhhhhhhhhhhgggabbbbaaa
aaabbbbbbbbbbbbbbbbbbbbbbbbaahhhhhhhhhhhhhhhhhhhhhhhhhhhhhhhhhhhhhhhhhhhhhhhhhhabbbbaaggghhhhhhhhhhhhhhhhhhhhhhhhhhhhabbbbaaa
aaabbbbbbbbbbbbbbbbbbbbbbbbaahhhhhhhhhhhhhhhhhhhhhhhhhhhhhhhhhhhhhhhhhhhhhhhhhhabbbbaaggghhhhhhhhhhhhhhhhhhhhhhhhhhhhabbbbaaa
aaabbbbbbbbbbbbbbbbbbbbbbbbaahhhhhhhhhhhhhhhhhhhhhhhhhhhhhhhhhhhhhhhhhhhhhhhhhhabbbbaaghhhhhhhhhhhhhhhhhhhhhhhhhhhhhhabbbbaaa
aaabbbbbbbbbbbbbbbbbbbbbbbbaahhhhhhhhhhhhhhhhhhhhhhhhhhhhhhhhhhhhhhhhhhhhhhhhhhabbbbaaghhhhhhhhhhhhhhhhhhhhhhhhhhhhhhabbbbaaa
aaabbbbbbbbbbbbbbbbbbbbbbbbaahhhhhhhhhhhhhhhhhhhhhhhhhhhhhhhhghhhhhhhhhhhhhhhhhabbbbaaghhhhhhhhhhhhhhhhhhhhhhhhhhhhhhabbbbaaa
aaabbbbbbbbbbbbbbbbbbbbbbbbaahhhhhhhhhhhhhhhhhhhhhhhhhhhhhghggghhhhhhhhhhhhhhhhabbbbaahhhggghhhhhhhhhhhhhhhhhhhhhhhhhaaabbaaa
aaabbbbbbbbbbbbbbbbbbbbbbbbaahhhhhhhhhhhhhhhhhhhhhhhhhggggggggghhhhhhhhhhhhhhhhabbbbaahhhggghhhhhhhhhhhhhhhhhhhhhhhhhggabbaaa
aaabbbbbbbbbbbbbbbbbbbbbbbbaahhhhhhhhhhhhhhhhhhhhhhhhhgghgggggggghhhhhhhhhhhhhhabbbbaahhhhhhhhhhhhhhhhhhhhhhhhhhhhhhgggabbaaa
aaabbbbbbbbbbbbbbbbbbbbbbbbaahhhhhhhhhhhhhhhhhhhhhhhhhghgggkkgggghhhhhhhhhhhhhhabbbbaaghhhhhhhhhhhhhhhhhhhhhhhhhhhhhghhabbaaa
aaabbbbbbbbbbbbbbbbbbbbbbbbaahhhhhhhhhhhhhhhhhhhhhhhhhhhggtggggghhhhhhhhhhhhgggabbbbaaaaaaaghhhhhhhhhhhhhhhhhhhhhhhhhhhaabaaa
aaabbbbbbbbbbbbbbbbbbbbbbbbaahhhhhhhhhhhhhhhhhhhhhhhhhhhhgggkggghhhhhhhhhhhhgggaaaabbbaaaaagggghhhhhhhhhhhhhhhhhhhhhhhhgabaaa
aaabbbbbbbbbbbbbbbbbbbbbbbbaahhhhhhhhhhgggghhhhhhhhhhhhhhgggggghhhhhhhhhhhhhggggggabbbbbbbaaggggggggghhhhggghhhhhhhhhhhgabaaa
aaabbbbbbbbbbbbbbbbbbbbbbbbaahhhhhhhggkgkgghhhhhhhhhhhhhhhhggghhhhhhhhhhhhhhggggggaaaabbbbaaggggggggghhhhggghhhhhhhhhhhgabaaa
aaabbbbbbbbbbbbbbbbbbbbbbbbaahhhhhhhggggkggghhhhhhhhhhhhhhhhhhhhhhhhhhhhhhhhhhgggggkgaabbbaaaaaaaaaaaaaahggghhhhhhhhhhhgabaaa
aaabbbbbbbbbbbbbbbbbbbbbbbbaahhhhhhhgggggggghhhhhhhhhhhhhhhhhhhhhhhhhhhhhhhhhhgagggggaabbbbaaaaaaaaaaaaahhhhhhhhhhhhhhhgabaaa
aaabbbbbbbbbbbbbbbbbbbbbbbbaahhhhhhhhghggggghhhhhhhhhhhhhhhhhhhhhhhhhhhhhhhhhhhaggkjgaabbbbbbbbbbbbbbbaahhhhhhhhhhhhhhhgabaaa
aaabbbbbbbbbbbbbbbbbbbbbbbbaahhhhhhhhhhgggghhhhhhhhhhhhhhhhhhhhhhhhhhhhhhhhhhhhagggggaaaaaaaaaaaabbbbaaaaaahhhhhhhhhhhhgabaaa
aaabbbbbbbbbbbbbbbbbbbbbbbbaahhhhhhhhhhhhhhhhhhhhhhhhhhhhhhhhhhhhhhhhhhhhhhhhhhaaaaggaagggggggggaaaaaaaaaaaahhhhhhhhhhhgabaaa
aaabbbbbbbbbbbbbbbbbbbbbbbbaahhhhhhhhhhhhhhhhhhhhhhhhhhhhhhhhhhhhhhhhhhhhhhhhhhabbaggaagggggggggaaaaaaaaaaaahhhhhhhhhhhhabaaa
aaabbbbbbbbbbbbbbbbbbbbbbbbaahhhhhhhhhhhhhhhhhhhhhhhhhhhhhhhhhhhhhhhhhhhhhhhhhhabbaagaaggggggggggggggggggaaahhhhhhhhhhhhabaaa
aaabbbbbbbbbbbbbbbbbbbbbbbbaahhhhhhhhhhhhhhhhhhhhhhhhhhhhhhhhhhhhhhhhhhhhhhhhhhabbbagggggggggggggggggggggaaahhhhhhhhhhhhabaaa
aaabbbbbbbbbbbbbbbbbbbbbbbbaahhhhhhhhhhhhhhhhhhhhhhhhhhhhhhhhhhhhhhhhhhhhhhhgggabbbagggggggggggggggggggggaaahhhhhhhhhhggabaaa
aaabbbbbbbbbbbbbbbbbbbbbbbbaahhhhhhhhhhhhhhhhhhhhhhhhhhhhhhhhhhhhhhhhhhhhhhhgggabbbaaaaaaggggggggggggggggaaahhhhhhhhhhggabaaa
aaabbbbbbbbbbbbbbbbbbbbbbbbaahhhhhhhhhhhhhhhhhhhhhhhhhhhhhhhhhhhhhhhhhhhhhhhgggabbbbbbbbaggggggggggggggggaaahhhhhhhhhhaaabaaa
aaabbbbbbbbbbbbbbbbbbbbbbbbaahhhhhhhhhhhhhhhhhhhhhhhhhhghhhhhhhhhhhhhhhhhhhhhhhabbbbbbbbaggggggggggggggggaaaghhhhhhhhgabbbaaa
aaabbbbbbbbbbbbbbbbbbbbbbbbaahhhhhhhhhhhhhhhhhhhhhhhhgggghhhhhhhhhhhhhhhhhhhhhhabbbbbbbbaggggtgggggggggggaaagghhhhhhggabbbaaa
aaabbbbbbbbbbbbbbbbbbbbbbbbaahhhhhhhhhhhhhhhhhhhhhhhgggtgghhhhhhhhhhhhhhhhhhhhgabbbbbbbbaggggggggggugggggaaaggggggggggabbbaaa
aaabbbbbbbbbbbbbbbbbbbbbbbbaahhhhhhhhhhhhhhhhhhhhhhgggggggghhhhhhhhhhhhhhhhhhhgabbbbbbbbaggggggglggggggggaaaggggggggggabbbaaa
aaabbbbbbbbbbbbbbbbbbbbbbbbaahhhhhhhhhhhhhhhhhhhhhhggggjgggghhhhhhhhhhhhhhhhhhgabbbbbbbbaggggggggggggggggaaaggggggggggabbbaaa
aaabbbbbbbbbbbbbbbbbbbbbbbbaahhhhhhhhhhhhhhhhhhhhhhgggjgggggghhhhhhhhhhhhhhhhhgabbbbbbbbaggggggggggggggggaaaggggggggggabbbaaa
aaabbbbbbbbbbbbbbbbbbbbbbbbaahhhhhhgggghhhhhhhhhhhhgggggggghhhhhhhhhhhhhhhhhhhgabbbbbbbbaggggggggggggggggaaaggkgggggggabbbaaa
aaabbbbbbbbbbbbbbbbbbbbbbbbaahhhhhhgggghhgghhhhhhhhhgggggghhhhhhhhhhhhhhhhhhhhgabbbbbbbbaggggggggggggggggaaagggggggggaaabbaaa
aaabbbbbbbbbbbbbbbbbbbbbbbbaahhhhhgggggghgghhhhhhhhhhhgggghhhhhhhhhhhhhhhhhhhhgabbbbbbbbaggggggggggggggggaaaggggggkggggabbaaa
aaabbbbbbbbbbbbbbbbbbbbbbbbaahhhhhggjjgggthhhhhhhhhhhhhhhhhhhhhhhhhhhhhhhhhhhhgabbbbbbbbaggggggggggggggggaaagggggggggggabbaaa
aaabbbbbbbbbbbbbbbbbbbbbbbbaahhhhhggjgggggghhhhhhhhhhhhhhhhhhhhhhhhhhhhhhhhhhhhabbbbbbbbaggggggggggggggggaaggggggggggggabbaaa
aaabbbbbbbbbbbbbbbbbbbbbbbbaahhhhhggggggghhhhhhhhhhhhhhhhhhhhhhhhhhhhhhhhhhhhhhabbbbbbbbaggggggggggggggggaaggggjgggggggaabaaa
aaabbbbbbbbbbbbbbbbbbbbbbbbaahhhhhhgggghhhhhhhhhhhhhhhhhhhhhhhhhhhhhhhhhhhhhhhhabbbbbbbbaggggggggggggggggaagggggggggggggabaaa
aaabbbbbbbbbbbbbbbbbbbbbbbbaahhhhhhhgggghhhhhhhhhhhhhhhhhhhhhhhhhhhhhhhhhhhhhhhabbbbbbbbaaaaaaaaaaaggggaaaagggggggggggggabaaa
aaabbbbbbbbbbbbbbbbbbbbbbbbaahhhhhhhhhhhhhhhhhhhhhhhhhhhhhhhhhhhhhhhhhhhhhhhhhhabbbbbbbbbbbbbbbbbbaggggaaaaggggggkggggggabaaa
aaabbbbbbbbbbbbbbbbbbbbbbbbaahhhhhhhhhhhhhhhhhhhhhhhhhhhhhhhhhhhhhhhhhhhhhhhhhhabbbbbbbbbbbbbbbbbbaggggaaaaggkggggggggggabaaa
aaabbbbbbbbbbbbbbbbbbbbbbbbaahhhhhhhhhhhhhhhhhhhhhhhhhhhhhhhhhhhhhhhhhhhhhhhhhhabbbbbbbbbbbbbbbbaaaggggaaaagggggggggggggabaaa
aaabbbbbbbbbbbbbbbbbbbbbbbbaahhhhhhhhhhhhhhhhhhhhhhhhhhhhhhhhhhhhhhhhhhhhhhhhhhabbbbbbbbbbbbbbbbaaaggggaaaagggggggggggggabaaa
aaabbbbbbbbbbbbbbbbbbbbbbbbaahhhhhhhhhhhhhhhhhhhhhhhhhhhhhhhhhhhhhhhhhhhhhhhhhhabbbbbbbbbbbbbbaaaggggggaaaagggggggggggggabaaa
aaabbbbbbbbbbbbbbbbbbbbbbbbaahhhhhhhhhhhhhhhhhhhhhhhhhhhhhhhhhhhhhhhhhhhhhhhhhhabbbbbbbbbbbbbbaaagggaaaaaaaggggggjggggggabaaa
aaabbbbbbbbbbbbbbbbbbbbbbbbaahhhhhhhhhhhhhhhhhhhhhhhhhhhhhhhhhhhhhhhhhhhhhhhhhhabbbbbbbbbbbbbaagggggaaaaaaagggggggggggggabaaa
aaabbbbbbbbbbbbbbbbbbbbbbbbaahhhhhhhhhhhhhhhhhhhhhhhhhhhhhhhhhhhhhhhhhhhhhhhhhhabbbbbbbbbbbbbaagggggaaagggggggggggggggggabaaa
aaabbbbbbbbbbbbbbbbbbbbbbbbaahhhhhhhhhhhhhhhhhhhhhhhhhhhhhhhhhhhhhhhhhhhhhhhhhhabbbbbbbbbbbbbaagggggaaagggggggggggggggggabaaa
aaabbbbbbbbbbbbbbbbbbbbbbbbaahhhhhhhhhhhhhhhhhhhhhhhhhhhhhhhhhhhhhhhhhhhhhhhhhhabbbbbbbbbbbbbaagggggaaggggggggggggggkgggabaaa
aaabbbbbbbbbbbbbbbbbbbbbbbbaahhhhhhhhhhhhhhhhhhhhhhhhhhhhhhhhhhhhhhhhhhhhhhhhhhabbbbbbbbbbbbbaagggggaaggggggggggggggggggabaaa
aaabbbbbbbbbbbbbbbbbbbbbbbbaahhhhhhhhhhgggggggggggggggggggggggghhhhhhhhhhhhhhhhabbbbbbbbbbbbbaagkgjgaaggggggggggggggggggabaaa
aaabbbbbbbbbbbbbbbbbbbbbbbbaahhhhhhhhhhggggggggggjgggggggggggggghhhhhhhhhhhhhhhabbbbbbbbbbbaaaaggkggaaggggggggggggggggggabaaa
aaabbbbbbbbbbbbbbbbbbbbbbbbaahhhhhhhhhgggggggggggggggggggggggjggghhhhhhhhhhhhhhabbbbbbbbbbbaaaagggggaaggggggggggggggggggabaaa
aaabbbbbbbbbbbbbbbbbbbbbbbbaahhhhhhhhggaaaaaaaaaaaagaaaaaaaaaaagghhhhhhhhhhhhhhabbbbbbbbbbbaaaagggggaaagggggggggggggggggabaaa
aaabbbbbbbbbbbbbbbbbbbbbbbbaahhhhhhhhggaaaaaaaaaaaamaaaaaaaaaaaggghhhhhhhhhhhhhaaaaaaaaaaaaagggggaaaaaggggggggggggggggggabaaa
aaabbbbbbbbbbbbbbbbbbbbbbbbaaghhhhhhhgaaagggggggggggggggggggaaaggghhhhhhhhhhhggaaaaaaaaaaaaagggggaaaaaggggggggggggggggggabaaa
aaabbbbbbbbbbbbbbbbbbbbbbbbaagghhhhhhgaaagggggggggggggggggggaaagggghhhhhhhhhhggggggggggggggggggggaaaaaggggggggggggggggggabaaa
aaabbbbbbbbbbbbbbbbbbbbbbbbaagggggggggaaagggggggggggggggggggaaagggghhhhhhhhhhggggggggggggggggggaaaaaggggggggggggggggggggabaaa
aaabbbbbbbbbbbbbbbbbbbbbbbbaagggggggggaaagggggggggggggggggggaaagggghhhhhhhhhgggaaaaaaaaaaaaaaaaaaaaaggggggggggggngggggggabaaa
aaabbbbbbbbbbbbbbbbbbbbbbbbaagggggggggaaaggggggggggoggggggggaaaggggghhhhhhgggggaaaaaaaaaaaaaaaaaaaaaggggggggggggggggggggabaaa
aaabbbbbbbbbbbbbbbbbbbbbbbbaagggggggggaaaggggggggggvggggggggaaaggggggggggggggggaaaaaaaaaaaaaaaaaaaggggggggggggggggggggggabaaa
aaabbbbbbbbbbbbbbbbbbbbbbbbaagggggggggaaagggggggggggwgggggggaaaggggggggggggggggaaaggxgggggggggggggggggggggggggggggggggggabaaa
aaabbbbbbbbbbbbbbbbbbbbbbbbaaaaaaaaaaaaaaaaaaaaaaaaaaeeeaaaaaaaaaaaaaaaaaaaaaaaaaagpggyggzggggggggggggggggggggggggggggggabaaa
aaabbbbbbbbbbbbbbbbbbbbbbbbbbbbbbbbbbbaaaaaaaaaaaaaaaeeeaaaaaaaaaaaaaaaaaaaaaaaaaaggwgggggggggggggggggggggggggggggggggggabaaa
aaabbbbbbbbbbbbbbbbbbbbbbbbbbbbbbbbbbbaaaaaaaaaaaaaaaefeaaaaaaaaaaaaaaaaaaaaaaaaaaaaaaaaaaaaaaaaaaaaaaaaaaaaaaaaaaaaaaaaabaaa
aaaaaaaaaaaaaaaaaaaaaaaaaaaaaaaaaaaaaaaaaaaaaaaaaaaaaaaaaaaaaaaaaaaaaaaaaaaaaaaaaaaaaaaaaaaaaaaaaaaaaaaaaaaaaaaaaaaaaaaaaaaaa
aaaaaaaaaaaaaaaaaaaaaaaaaaaaaaaaaaaaaaaaaaaaaaaaaaaaaaaaaaaaaaaaaaaaaaaaaaaaaaaaaaaaaaaaaaaaaaaaaaaaaaaaaaaaaaaaaaaaaaaaaaaaa
aaaaaaaaaaaaaaaaaaaaaaaaaaaaaaaaaaaaaaaaaaaaaaaaaaaaaaaaaaaaaaaaaaaaaaaaaaaaaaaaaaaaaaaaaaaaaaaaaaaaaaaaaaaaaaaaaaaaaaaaaaaaa
"}
